Наименование юр. лица;Должность;Суммарная ставка;Требуемое количество талонов на неделю;Количество всех талонов в расписании;Количество КТ доступных для онлайн записи;Количество НКТ по фактам записи;Доля КТ от требуемого количества;Общее количество всех переданных талонов по фактам записи;Число врачей без расписания
"ГБУЗ ""АБИНСКАЯ ЦРБ"" МЗ КК";врач общей практики (семейный врач);5.5;715;521;499;22;0.7;306;1
"ГБУЗ ""АБИНСКАЯ ЦРБ"" МЗ КК";врач-акушер-гинеколог;5;550;500;262;238;0.48;483;0
"ГБУЗ ""АБИНСКАЯ ЦРБ"" МЗ КК";врач-оториноларинголог;2;300;278;196;82;0.65;251;0
"ГБУЗ ""АБИНСКАЯ ЦРБ"" МЗ КК";врач-офтальмолог;2.5;425;304;239;65;0.56;280;0
"ГБУЗ ""АБИНСКАЯ ЦРБ"" МЗ КК";врач-педиатр участковый;11.75;1645;1628;1580;48;0.96;1138;0
"ГБУЗ ""АБИНСКАЯ ЦРБ"" МЗ КК";врач-психиатр детский;1;85;80;37;43;0.44;80;0
"ГБУЗ ""АБИНСКАЯ ЦРБ"" МЗ КК";врач-психиатр-нарколог;2;170;130;130;0;0.76;1;1
"ГБУЗ ""АБИНСКАЯ ЦРБ"" МЗ КК";врач-стоматолог;8.25;370;362;345;17;0.93;215;3
"ГБУЗ ""АБИНСКАЯ ЦРБ"" МЗ КК";врач-стоматолог детский;1;44;44;24;20;0.55;44;1
"ГБУЗ ""АБИНСКАЯ ЦРБ"" МЗ КК";врач-стоматолог-терапевт;4;180;167;122;45;0.68;155;1
"ГБУЗ ""АБИНСКАЯ ЦРБ"" МЗ КК";врач-терапевт участковый;19;2660;1992;1844;148;0.69;297;3
"ГБУЗ ""АБИНСКАЯ ЦРБ"" МЗ КК";врач-фтизиатр;4;219;171;170;1;0.78;82;0
"ГБУЗ ""АБИНСКАЯ ЦРБ"" МЗ КК";врач-хирург;3;255;288;261;27;1.02;263;0
"ГБУЗ ""ГОРОДСКАЯ БОЛЬНИЦА АНАПЫ""";врач - детский хирург;1.5;127;294;242;52;1.91;288;0
"ГБУЗ ""ГОРОДСКАЯ БОЛЬНИЦА АНАПЫ""";врач общей практики (семейный врач);2.75;357;629;553;76;1.55;413;0
"ГБУЗ ""ГОРОДСКАЯ БОЛЬНИЦА АНАПЫ""";врач-акушер-гинеколог;19.25;2116;2062;1600;462;0.76;1905;0
"ГБУЗ ""ГОРОДСКАЯ БОЛЬНИЦА АНАПЫ""";врач-оториноларинголог;3.5;524;586;421;165;0.8;542;0
"ГБУЗ ""ГОРОДСКАЯ БОЛЬНИЦА АНАПЫ""";врач-офтальмолог;4.5;764;482;284;198;0.37;482;2
"ГБУЗ ""ГОРОДСКАЯ БОЛЬНИЦА АНАПЫ""";врач-педиатр участковый;40.5;5670;5549;4970;579;0.88;4279;2
"ГБУЗ ""ГОРОДСКАЯ БОЛЬНИЦА АНАПЫ""";врач-психиатр детский;1;85;124;115;9;1.35;124;0
"ГБУЗ ""ГОРОДСКАЯ БОЛЬНИЦА АНАПЫ""";врач-психиатр-нарколог;3.5;296;265;265;0;0.9;145;0
"ГБУЗ ""ГОРОДСКАЯ БОЛЬНИЦА АНАПЫ""";врач-стоматолог;13.75;618;802;539;263;0.87;697;2
"ГБУЗ ""ГОРОДСКАЯ БОЛЬНИЦА АНАПЫ""";врач-стоматолог детский;5.5;247;216;86;130;0.35;216;0
"ГБУЗ ""ГОРОДСКАЯ БОЛЬНИЦА АНАПЫ""";врач-стоматолог-терапевт;8.5;382;497;369;128;0.97;396;0
"ГБУЗ ""ГОРОДСКАЯ БОЛЬНИЦА АНАПЫ""";врач-терапевт участковый;51.25;7175;7723;6692;1031;0.93;6498;3
"ГБУЗ ""ГОРОДСКАЯ БОЛЬНИЦА АНАПЫ""";врач-фтизиатр участковый;3.75;205;208;168;40;0.82;105;0
"ГБУЗ ""ГОРОДСКАЯ БОЛЬНИЦА АНАПЫ""";врач-хирург;6;510;631;483;148;0.95;594;0
"ГБУЗ ""ХАДЫЖЕНСКАЯ СТОМАТОЛОГИЧЕСКАЯ ПОЛИКЛИНИКА""";врач-стоматолог;1.75;78;50;40;10;0.51;50;1
"ГБУЗ ""ХАДЫЖЕНСКАЯ СТОМАТОЛОГИЧЕСКАЯ ПОЛИКЛИНИКА""";врач-стоматолог-терапевт;0.5;22;0;0;0;0;0;1
"ГБУЗ ""ЦРБ АПШЕРОНСКОГО РАЙОНА"" МЗ КК";врач - детский хирург;1;85;250;250;0;2.94;232;0
"ГБУЗ ""ЦРБ АПШЕРОНСКОГО РАЙОНА"" МЗ КК";врач общей практики (семейный врач);3.25;422;445;445;0;1.05;75;0
"ГБУЗ ""ЦРБ АПШЕРОНСКОГО РАЙОНА"" МЗ КК";врач-акушер-гинеколог;4;439;533;413;120;0.94;485;0
"ГБУЗ ""ЦРБ АПШЕРОНСКОГО РАЙОНА"" МЗ КК";врач-оториноларинголог;1.5;225;162;160;2;0.71;159;0
"ГБУЗ ""ЦРБ АПШЕРОНСКОГО РАЙОНА"" МЗ КК";врач-офтальмолог;1;170;160;160;0;0.94;0;0
"ГБУЗ ""ЦРБ АПШЕРОНСКОГО РАЙОНА"" МЗ КК";врач-педиатр участковый;15;2100;2357;2328;29;1.11;1546;0
"ГБУЗ ""ЦРБ АПШЕРОНСКОГО РАЙОНА"" МЗ КК";врач-психиатр-нарколог;1.5;127;130;130;0;1.02;0;0
"ГБУЗ ""ЦРБ АПШЕРОНСКОГО РАЙОНА"" МЗ КК";врач-терапевт участковый;18.5;2590;2417;2407;10;0.93;1447;0
"ГБУЗ ""ЦРБ АПШЕРОНСКОГО РАЙОНА"" МЗ КК";врач-хирург;3.5;296;357;265;92;0.9;354;0
"ГБУЗ ""ГОРОДСКАЯ БОЛЬНИЦА Г. АРМАВИРА"" МЗ КК";врач общей практики (семейный врач);1.5;195;162;100;62;0.51;154;0
"ГБУЗ ""ГОРОДСКАЯ БОЛЬНИЦА Г. АРМАВИРА"" МЗ КК";врач-акушер-гинеколог;1.5;165;155;152;3;0.92;110;1
"ГБУЗ ""ГОРОДСКАЯ БОЛЬНИЦА Г. АРМАВИРА"" МЗ КК";врач-оториноларинголог;3.5;525;436;359;77;0.68;384;0
"ГБУЗ ""ГОРОДСКАЯ БОЛЬНИЦА Г. АРМАВИРА"" МЗ КК";врач-офтальмолог;4;680;614;415;199;0.61;562;0
"ГБУЗ ""ГОРОДСКАЯ БОЛЬНИЦА Г. АРМАВИРА"" МЗ КК";врач-терапевт участковый;24.25;3395;3025;2451;574;0.72;2771;4
"ГБУЗ ""ГОРОДСКАЯ БОЛЬНИЦА Г. АРМАВИРА"" МЗ КК";врач-хирург;4.75;403;479;244;235;0.61;469;1
"ГБУЗ ""ДБ Г.АРМАВИРА"" МЗ КК";врач - детский хирург;1.75;148;225;158;67;1.07;224;0
"ГБУЗ ""ДБ Г.АРМАВИРА"" МЗ КК";врач-акушер-гинеколог;1;110;110;110;0;1;79;0
"ГБУЗ ""ДБ Г.АРМАВИРА"" МЗ КК";врач-оториноларинголог;2;300;310;263;47;0.88;306;0
"ГБУЗ ""ДБ Г.АРМАВИРА"" МЗ КК";врач-офтальмолог;1.5;255;200;184;16;0.72;196;0
"ГБУЗ ""ДБ Г.АРМАВИРА"" МЗ КК";врач-педиатр участковый;18;2520;4497;4368;129;1.73;2114;1
"ГБУЗ ""ДБ Г.АРМАВИРА"" МЗ КК";врач-стоматолог детский;1;45;53;0;53;0;53;0
"ГБУЗ ""ПНД № 2""";врач-психиатр детский;3.5;296;125;125;0;0.42;79;3
"ГБУЗ ""ПЦ"" МЗ КК";врач-акушер-гинеколог;13;1428;1268;1153;115;0.81;1092;0
ГБУЗ АПТД;врач-фтизиатр;0.25;13;0;0;0;0;0;1
ГБУЗ АПТД;врач-фтизиатр участковый;13.75;751;1311;1295;16;1.72;590;1
ГБУЗ ДСП ГОРОДА АРМАВИРА МЗ КК;врач-стоматолог;4;180;310;168;142;0.93;301;0
ГБУЗ ДСП ГОРОДА АРМАВИРА МЗ КК;врач-стоматолог детский;2;90;142;91;51;1.01;142;0
ГБУЗ СП Г. АРМАВИРА МЗКК;врач-стоматолог;7;314;374;374;0;1.19;0;2
ГБУЗ СП Г. АРМАВИРА МЗКК;врач-стоматолог-терапевт;11.75;528;626;579;47;1.1;565;1
"ГБУЗ ""БЕЛОГЛИНСКАЯ СТОМАТОЛОГИЧЕСКАЯ ПОЛИКЛИНИКА"" МЗ КК";врач-стоматолог;5;225;294;185;109;0.82;288;0
"ГБУЗ ""БЕЛОГЛИНСКАЯ СТОМАТОЛОГИЧЕСКАЯ ПОЛИКЛИНИКА"" МЗ КК";врач-стоматолог детский;1;45;0;0;0;0;0;1
"ГБУЗ ""БЕЛОГЛИНСКАЯ СТОМАТОЛОГИЧЕСКАЯ ПОЛИКЛИНИКА"" МЗ КК";врач-стоматолог-терапевт;1;45;60;60;0;1.33;47;0
"ГБУЗ ""БЕЛОГЛИНСКАЯ ЦРБ"" МЗ КК";врач общей практики (семейный врач);3;390;633;632;1;1.62;105;0
"ГБУЗ ""БЕЛОГЛИНСКАЯ ЦРБ"" МЗ КК";врач-акушер-гинеколог;2;220;120;81;39;0.37;120;1
"ГБУЗ ""БЕЛОГЛИНСКАЯ ЦРБ"" МЗ КК";врач-оториноларинголог;1;150;112;112;0;0.75;112;0
"ГБУЗ ""БЕЛОГЛИНСКАЯ ЦРБ"" МЗ КК";врач-офтальмолог;1;170;100;78;22;0.46;100;0
"ГБУЗ ""БЕЛОГЛИНСКАЯ ЦРБ"" МЗ КК";врач-педиатр участковый;5;700;676;675;1;0.96;398;0
"ГБУЗ ""БЕЛОГЛИНСКАЯ ЦРБ"" МЗ КК";врач-психиатр-нарколог;0;0;20;20;0;0;0;0
"ГБУЗ ""БЕЛОГЛИНСКАЯ ЦРБ"" МЗ КК";врач-терапевт участковый;4;560;480;472;8;0.84;416;0
"ГБУЗ ""БЕЛОГЛИНСКАЯ ЦРБ"" МЗ КК";врач-фтизиатр участковый;1;55;100;100;0;1.82;0;0
"ГБУЗ ""БЕЛОГЛИНСКАЯ ЦРБ"" МЗ КК";врач-хирург;1.75;148;176;131;45;0.89;176;0
"ГБУЗ ""БЕЛОРЕЧЕНСКАЯ СТОМАТОЛОГИЧЕСКАЯ ПОЛИКЛИНИКА"" МЗ КК";врач-стоматолог;6.5;292;487;391;96;1.34;283;0
"ГБУЗ ""БЕЛОРЕЧЕНСКАЯ СТОМАТОЛОГИЧЕСКАЯ ПОЛИКЛИНИКА"" МЗ КК";врач-стоматолог детский;2.5;112;115;69;46;0.62;114;0
"ГБУЗ ""БЕЛОРЕЧЕНСКАЯ СТОМАТОЛОГИЧЕСКАЯ ПОЛИКЛИНИКА"" МЗ КК";врач-стоматолог-терапевт;1;44;20;15;5;0.34;20;1
"ГБУЗ ""БЕЛОРЕЧЕНСКАЯ ЦРБ"" МЗ КК";врач - детский хирург;1;85;121;102;19;1.2;121;0
"ГБУЗ ""БЕЛОРЕЧЕНСКАЯ ЦРБ"" МЗ КК";врач общей практики (семейный врач);2;260;355;336;19;1.29;210;0
"ГБУЗ ""БЕЛОРЕЧЕНСКАЯ ЦРБ"" МЗ КК";врач-акушер-гинеколог;3.5;384;353;235;118;0.61;353;1
"ГБУЗ ""БЕЛОРЕЧЕНСКАЯ ЦРБ"" МЗ КК";врач-оториноларинголог;2.5;374;271;233;38;0.62;248;0
"ГБУЗ ""БЕЛОРЕЧЕНСКАЯ ЦРБ"" МЗ КК";врач-офтальмолог;2.5;424;353;253;100;0.6;343;0
"ГБУЗ ""БЕЛОРЕЧЕНСКАЯ ЦРБ"" МЗ КК";врач-педиатр участковый;16;2240;2388;2116;272;0.94;1779;1
"ГБУЗ ""БЕЛОРЕЧЕНСКАЯ ЦРБ"" МЗ КК";врач-стоматолог;3.75;168;180;180;0;1.07;14;0
"ГБУЗ ""БЕЛОРЕЧЕНСКАЯ ЦРБ"" МЗ КК";врач-стоматолог детский;0.25;11;0;0;0;0;0;1
"ГБУЗ ""БЕЛОРЕЧЕНСКАЯ ЦРБ"" МЗ КК";врач-терапевт участковый;27;3780;3315;2913;402;0.77;2333;3
"ГБУЗ ""БЕЛОРЕЧЕНСКАЯ ЦРБ"" МЗ КК";врач-хирург;2;170;258;199;59;1.17;258;0
"ГБУЗ ""ПТД № 6"" МЗ КК";врач-оториноларинголог;0.25;37;0;0;0;0;0;1
"ГБУЗ ""ПТД № 6"" МЗ КК";врач-фтизиатр;0;0;106;99;7;0;91;0
"ГБУЗ ""ПТД № 6"" МЗ КК";врач-фтизиатр участковый;10;548;480;480;0;0.88;194;3
"ГБУЗ ""БРЮХОВЕЦКАЯ ЦРБ"" МЗ КК";врач - детский хирург;0.25;21;30;30;0;1.43;30;0
"ГБУЗ ""БРЮХОВЕЦКАЯ ЦРБ"" МЗ КК";врач общей практики (семейный врач);2;260;201;190;11;0.73;125;1
"ГБУЗ ""БРЮХОВЕЦКАЯ ЦРБ"" МЗ КК";врач-акушер-гинеколог;1;110;519;481;38;4.37;245;0
"ГБУЗ ""БРЮХОВЕЦКАЯ ЦРБ"" МЗ КК";врач-оториноларинголог;1.25;187;230;195;35;1.04;54;0
"ГБУЗ ""БРЮХОВЕЦКАЯ ЦРБ"" МЗ КК";врач-офтальмолог;2.5;424;394;280;114;0.66;146;0
"ГБУЗ ""БРЮХОВЕЦКАЯ ЦРБ"" МЗ КК";врач-педиатр участковый;7.75;1085;1041;964;77;0.89;768;3
"ГБУЗ ""БРЮХОВЕЦКАЯ ЦРБ"" МЗ КК";врач-психиатр детский;1;85;174;174;0;2.05;30;0
"ГБУЗ ""БРЮХОВЕЦКАЯ ЦРБ"" МЗ КК";врач-психиатр-нарколог;2;170;88;20;68;0.12;86;0
"ГБУЗ ""БРЮХОВЕЦКАЯ ЦРБ"" МЗ КК";врач-стоматолог;8;359;590;588;2;1.64;161;3
"ГБУЗ ""БРЮХОВЕЦКАЯ ЦРБ"" МЗ КК";врач-стоматолог детский;1;45;11;10;1;0.22;7;1
"ГБУЗ ""БРЮХОВЕЦКАЯ ЦРБ"" МЗ КК";врач-стоматолог-терапевт;2.5;112;115;110;5;0.98;67;2
"ГБУЗ ""БРЮХОВЕЦКАЯ ЦРБ"" МЗ КК";врач-терапевт участковый;10.75;1505;1791;1670;121;1.11;806;0
"ГБУЗ ""БРЮХОВЕЦКАЯ ЦРБ"" МЗ КК";врач-фтизиатр участковый;2;110;64;0;64;0;64;1
"ГБУЗ ""БРЮХОВЕЦКАЯ ЦРБ"" МЗ КК";врач-хирург;1.5;127;34;0;34;0;34;0
ГБУЗ ВЫСЕЛКОВСКАЯ ЦРБ;врач - детский хирург;2;170;235;220;15;1.29;125;0
ГБУЗ ВЫСЕЛКОВСКАЯ ЦРБ;врач общей практики (семейный врач);11.75;1527;1488;1410;78;0.92;771;2
ГБУЗ ВЫСЕЛКОВСКАЯ ЦРБ;врач-акушер-гинеколог;7;769;733;645;88;0.84;525;1
ГБУЗ ВЫСЕЛКОВСКАЯ ЦРБ;врач-оториноларинголог;2;300;300;273;27;0.91;292;0
ГБУЗ ВЫСЕЛКОВСКАЯ ЦРБ;врач-офтальмолог;3;510;270;240;30;0.47;236;1
ГБУЗ ВЫСЕЛКОВСКАЯ ЦРБ;врач-педиатр участковый;12;1680;2193;2129;64;1.27;665;1
ГБУЗ ВЫСЕЛКОВСКАЯ ЦРБ;врач-психиатр детский;1;85;129;128;1;1.51;53;0
ГБУЗ ВЫСЕЛКОВСКАЯ ЦРБ;врач-психиатр-нарколог;2.25;191;340;340;0;1.78;110;0
ГБУЗ ВЫСЕЛКОВСКАЯ ЦРБ;врач-терапевт участковый;13.5;1890;1800;1625;175;0.86;1104;0
ГБУЗ ВЫСЕЛКОВСКАЯ ЦРБ;врач-хирург;2;170;159;128;31;0.75;126;0
"ГБУЗ ""ГБ ГОРОДА-КУРОРТА ГЕЛЕНДЖИК"" МЗ КК";врач - детский хирург;1;85;112;112;0;1.32;99;0
"ГБУЗ ""ГБ ГОРОДА-КУРОРТА ГЕЛЕНДЖИК"" МЗ КК";врач-акушер-гинеколог;8.5;935;522;385;137;0.41;495;0
"ГБУЗ ""ГБ ГОРОДА-КУРОРТА ГЕЛЕНДЖИК"" МЗ КК";врач-оториноларинголог;1;150;108;108;0;0.72;99;0
"ГБУЗ ""ГБ ГОРОДА-КУРОРТА ГЕЛЕНДЖИК"" МЗ КК";врач-офтальмолог;2;340;50;50;0;0.15;2;2
"ГБУЗ ""ГБ ГОРОДА-КУРОРТА ГЕЛЕНДЖИК"" МЗ КК";врач-педиатр участковый;16;2240;2022;1824;198;0.81;1798;1
"ГБУЗ ""ГБ ГОРОДА-КУРОРТА ГЕЛЕНДЖИК"" МЗ КК";врач-стоматолог;1;45;0;0;0;0;0;1
"ГБУЗ ""ГБ ГОРОДА-КУРОРТА ГЕЛЕНДЖИК"" МЗ КК";врач-стоматолог-терапевт;0;0;55;53;2;0;42;0
"ГБУЗ ""ГБ ГОРОДА-КУРОРТА ГЕЛЕНДЖИК"" МЗ КК";врач-терапевт участковый;3;420;169;124;45;0.3;158;1
"ГБУЗ ""ГБ ГОРОДА-КУРОРТА ГЕЛЕНДЖИК"" МЗ КК";врач-хирург;1;85;82;82;0;0.96;9;0
"ГБУЗ ""ГП ГОРОДА-КУРОРТА ГЕЛЕНДЖИК"" МЗ КК";врач общей практики (семейный врач);1;130;134;134;0;1.03;16;0
"ГБУЗ ""ГП ГОРОДА-КУРОРТА ГЕЛЕНДЖИК"" МЗ КК";врач-акушер-гинеколог;2.5;275;375;176;199;0.64;330;0
"ГБУЗ ""ГП ГОРОДА-КУРОРТА ГЕЛЕНДЖИК"" МЗ КК";врач-оториноларинголог;1;150;91;15;76;0.1;91;0
"ГБУЗ ""ГП ГОРОДА-КУРОРТА ГЕЛЕНДЖИК"" МЗ КК";врач-офтальмолог;1.25;212;81;0;81;0;81;1
"ГБУЗ ""ГП ГОРОДА-КУРОРТА ГЕЛЕНДЖИК"" МЗ КК";врач-педиатр участковый;6;840;701;699;2;0.83;353;1
"ГБУЗ ""ГП ГОРОДА-КУРОРТА ГЕЛЕНДЖИК"" МЗ КК";врач-психиатр-нарколог;2;170;170;170;0;1;9;0
"ГБУЗ ""ГП ГОРОДА-КУРОРТА ГЕЛЕНДЖИК"" МЗ КК";врач-стоматолог;1.5;67;40;40;0;0.6;11;1
"ГБУЗ ""ГП ГОРОДА-КУРОРТА ГЕЛЕНДЖИК"" МЗ КК";врач-стоматолог детский;0.75;33;35;35;0;1.06;0;0
"ГБУЗ ""ГП ГОРОДА-КУРОРТА ГЕЛЕНДЖИК"" МЗ КК";врач-стоматолог-терапевт;0.25;11;15;15;0;1.36;0;0
"ГБУЗ ""ГП ГОРОДА-КУРОРТА ГЕЛЕНДЖИК"" МЗ КК";врач-терапевт участковый;22;3080;2260;1905;355;0.62;1760;5
"ГБУЗ ""ГП ГОРОДА-КУРОРТА ГЕЛЕНДЖИК"" МЗ КК";врач-хирург;5.25;445;332;292;40;0.66;294;2
"ГБУЗ ""СТОМАТОЛОГИЧЕСКАЯ ПОЛИКЛИНИКА ГОРОДА-КУРОРТА ГЕЛЕНДЖИК"" МЗ КК";врач-стоматолог;8.75;393;311;132;179;0.34;309;2
"ГБУЗ ""СТОМАТОЛОГИЧЕСКАЯ ПОЛИКЛИНИКА ГОРОДА-КУРОРТА ГЕЛЕНДЖИК"" МЗ КК";врач-стоматолог детский;1.75;78;100;38;62;0.49;100;0
"ГБУЗ ""СТОМАТОЛОГИЧЕСКАЯ ПОЛИКЛИНИКА ГОРОДА-КУРОРТА ГЕЛЕНДЖИК"" МЗ КК";врач-стоматолог-терапевт;6.5;291;173;82;91;0.28;173;4
"ГБУЗ ""ГОРЯЧЕКЛЮЧЕВСКАЯ ЦРБ"" МЗ КК";врач общей практики (семейный врач);5;650;589;472;117;0.73;458;0
"ГБУЗ ""ГОРЯЧЕКЛЮЧЕВСКАЯ ЦРБ"" МЗ КК";врач-акушер-гинеколог;3.5;385;400;248;152;0.64;325;1
"ГБУЗ ""ГОРЯЧЕКЛЮЧЕВСКАЯ ЦРБ"" МЗ КК";врач-оториноларинголог;1.5;225;152;100;52;0.44;152;0
"ГБУЗ ""ГОРЯЧЕКЛЮЧЕВСКАЯ ЦРБ"" МЗ КК";врач-офтальмолог;2.5;424;307;247;60;0.58;295;0
"ГБУЗ ""ГОРЯЧЕКЛЮЧЕВСКАЯ ЦРБ"" МЗ КК";врач-педиатр участковый;7.5;1050;1084;1021;63;0.97;904;0
"ГБУЗ ""ГОРЯЧЕКЛЮЧЕВСКАЯ ЦРБ"" МЗ КК";врач-психиатр-нарколог;1.25;106;52;52;0;0.49;3;0
"ГБУЗ ""ГОРЯЧЕКЛЮЧЕВСКАЯ ЦРБ"" МЗ КК";врач-терапевт участковый;14.5;2030;1582;1472;110;0.73;1227;2
"ГБУЗ ""ГОРЯЧЕКЛЮЧЕВСКАЯ ЦРБ"" МЗ КК";врач-хирург;2.25;191;189;133;56;0.7;189;0
"ГБУЗ ""СТОМАТОЛОГИЧЕСКАЯ ПОЛИКЛИНИКА Г.ГОРЯЧИЙ КЛЮЧ"" МЗ КК";врач-стоматолог;3.5;156;136;112;24;0.72;135;2
"ГБУЗ ""СТОМАТОЛОГИЧЕСКАЯ ПОЛИКЛИНИКА Г.ГОРЯЧИЙ КЛЮЧ"" МЗ КК";врач-стоматолог детский;2;90;70;55;15;0.61;70;0
"ГБУЗ ""СТОМАТОЛОГИЧЕСКАЯ ПОЛИКЛИНИКА Г.ГОРЯЧИЙ КЛЮЧ"" МЗ КК";врач-стоматолог-терапевт;2;88;69;48;21;0.55;69;1
"ГАУЗ ""ГУЛЬКЕВИЧСКАЯ СТОМАТОЛОГИЧЕСКАЯ ПОЛИКЛИНИКА"" МЗ КК";врач-стоматолог;15.25;684;757;639;118;0.93;530;3
"ГАУЗ ""ГУЛЬКЕВИЧСКАЯ СТОМАТОЛОГИЧЕСКАЯ ПОЛИКЛИНИКА"" МЗ КК";врач-стоматолог детский;2.25;101;83;60;23;0.59;81;0
"ГАУЗ ""ГУЛЬКЕВИЧСКАЯ СТОМАТОЛОГИЧЕСКАЯ ПОЛИКЛИНИКА"" МЗ КК";врач-стоматолог-терапевт;1;44;40;40;0;0.91;27;1
ГБУЗ ГУЛЬКЕВИЧСКАЯ ЦРБ;врач - детский хирург;0.25;21;20;0;20;0;20;0
ГБУЗ ГУЛЬКЕВИЧСКАЯ ЦРБ;врач-акушер-гинеколог;8.75;961;329;246;83;0.26;316;4
ГБУЗ ГУЛЬКЕВИЧСКАЯ ЦРБ;врач-оториноларинголог;1.5;224;112;77;35;0.34;112;0
ГБУЗ ГУЛЬКЕВИЧСКАЯ ЦРБ;врач-офтальмолог;3.25;552;319;308;11;0.56;319;0
ГБУЗ ГУЛЬКЕВИЧСКАЯ ЦРБ;врач-педиатр участковый;13.75;1925;1812;1641;171;0.85;1088;1
ГБУЗ ГУЛЬКЕВИЧСКАЯ ЦРБ;врач-психиатр-нарколог;1.25;106;16;16;0;0.15;8;0
ГБУЗ ГУЛЬКЕВИЧСКАЯ ЦРБ;врач-терапевт участковый;15.5;2170;2222;2021;201;0.93;1570;1
ГБУЗ ГУЛЬКЕВИЧСКАЯ ЦРБ;врач-хирург;2.25;191;229;198;31;1.04;197;0
"ГБУЗ ""ДИНСКАЯ ЦРБ"" МЗ КК";врач - детский хирург;2;170;380;287;93;1.69;351;0
"ГБУЗ ""ДИНСКАЯ ЦРБ"" МЗ КК";врач общей практики (семейный врач);3;390;665;653;12;1.67;219;0
"ГБУЗ ""ДИНСКАЯ ЦРБ"" МЗ КК";врач-акушер-гинеколог;13.25;1457;1383;1110;273;0.76;976;1
"ГБУЗ ""ДИНСКАЯ ЦРБ"" МЗ КК";врач-оториноларинголог;2;300;266;140;126;0.47;266;0
"ГБУЗ ""ДИНСКАЯ ЦРБ"" МЗ КК";врач-офтальмолог;1.5;255;262;211;51;0.83;262;0
"ГБУЗ ""ДИНСКАЯ ЦРБ"" МЗ КК";врач-педиатр участковый;19;2660;3261;2616;645;0.98;2362;0
"ГБУЗ ""ДИНСКАЯ ЦРБ"" МЗ КК";врач-психиатр детский;1;84;40;40;0;0.48;9;1
"ГБУЗ ""ДИНСКАЯ ЦРБ"" МЗ КК";врач-психиатр-нарколог;2;170;336;336;0;1.98;8;0
"ГБУЗ ""ДИНСКАЯ ЦРБ"" МЗ КК";врач-стоматолог;14;629;1194;821;373;1.31;858;2
"ГБУЗ ""ДИНСКАЯ ЦРБ"" МЗ КК";врач-стоматолог детский;3;135;144;85;59;0.63;144;0
"ГБУЗ ""ДИНСКАЯ ЦРБ"" МЗ КК";врач-стоматолог-терапевт;5.75;258;165;124;41;0.48;144;2
"ГБУЗ ""ДИНСКАЯ ЦРБ"" МЗ КК";врач-терапевт участковый;28.5;3990;4269;3489;780;0.87;3398;1
"ГБУЗ ""ДИНСКАЯ ЦРБ"" МЗ КК";врач-хирург;3.5;297;378;309;69;1.04;333;1
"ГБУЗ ""ЕЙСКАЯ ЦРБ"" МЗ КК";врач - детский хирург;0.25;21;0;0;0;0;0;1
"ГБУЗ ""ЕЙСКАЯ ЦРБ"" МЗ КК";врач общей практики (семейный врач);9.75;1267;1646;1645;1;1.3;525;1
"ГБУЗ ""ЕЙСКАЯ ЦРБ"" МЗ КК";врач-акушер-гинеколог;9;989;837;539;298;0.54;522;1
"ГБУЗ ""ЕЙСКАЯ ЦРБ"" МЗ КК";врач-оториноларинголог;4.75;712;561;432;129;0.61;539;1
"ГБУЗ ""ЕЙСКАЯ ЦРБ"" МЗ КК";врач-офтальмолог;3.5;595;420;316;104;0.53;419;0
"ГБУЗ ""ЕЙСКАЯ ЦРБ"" МЗ КК";врач-педиатр участковый;21.75;3045;2762;2412;350;0.79;1983;1
"ГБУЗ ""ЕЙСКАЯ ЦРБ"" МЗ КК";врач-психиатр-нарколог;0.25;21;30;30;0;1.43;0;0
"ГБУЗ ""ЕЙСКАЯ ЦРБ"" МЗ КК";врач-стоматолог;1.25;56;225;225;0;4.02;0;1
"ГБУЗ ""ЕЙСКАЯ ЦРБ"" МЗ КК";врач-стоматолог детский;0.25;11;0;0;0;0;0;1
"ГБУЗ ""ЕЙСКАЯ ЦРБ"" МЗ КК";врач-терапевт участковый;27;3780;3612;2982;630;0.79;2557;3
"ГБУЗ ""ЕЙСКАЯ ЦРБ"" МЗ КК";врач-хирург;3;254;377;284;93;1.12;301;0
"ГБУЗ ""ЕПНД""";врач-психиатр детский;1.5;127;167;167;0;1.31;148;0
"ГБУЗ ""ПТД №7""";врач-фтизиатр участковый;8.25;450;781;776;5;1.72;534;1
"ГБУЗ ""СТОМАТОЛОГИЧЕСКАЯ ПОЛИКЛИНИКА ЕЙСКОГО РАЙОНА"" МЗ КК";врач-стоматолог;14;628;931;842;89;1.34;475;1
"ГБУЗ ""СТОМАТОЛОГИЧЕСКАЯ ПОЛИКЛИНИКА ЕЙСКОГО РАЙОНА"" МЗ КК";врач-стоматолог детский;1.25;56;59;16;43;0.29;59;0
"ГБУЗ ""СТОМАТОЛОГИЧЕСКАЯ ПОЛИКЛИНИКА ЕЙСКОГО РАЙОНА"" МЗ КК";врач-стоматолог-терапевт;3.5;157;143;128;15;0.82;72;0
"ГБУЗ ""ГБ Г. КРОПОТКИНА"" МЗ КК";врач - детский хирург;0.25;21;75;0;75;0;75;0
"ГБУЗ ""ГБ Г. КРОПОТКИНА"" МЗ КК";врач общей практики (семейный врач);0.5;65;64;64;0;0.98;10;0
"ГБУЗ ""ГБ Г. КРОПОТКИНА"" МЗ КК";врач-акушер-гинеколог;7.5;824;539;409;130;0.5;490;1
"ГБУЗ ""ГБ Г. КРОПОТКИНА"" МЗ КК";врач-оториноларинголог;1.25;187;112;90;22;0.48;112;0
"ГБУЗ ""ГБ Г. КРОПОТКИНА"" МЗ КК";врач-офтальмолог;1.25;212;129;129;0;0.61;129;0
"ГБУЗ ""ГБ Г. КРОПОТКИНА"" МЗ КК";врач-педиатр участковый;11.5;1610;1610;1610;0;1;1122;0
"ГБУЗ ""ГБ Г. КРОПОТКИНА"" МЗ КК";врач-стоматолог;5.5;247;245;245;0;0.99;212;0
"ГБУЗ ""ГБ Г. КРОПОТКИНА"" МЗ КК";врач-стоматолог детский;5;224;224;193;31;0.86;224;0
"ГБУЗ ""ГБ Г. КРОПОТКИНА"" МЗ КК";врач-стоматолог-терапевт;6;268;254;229;25;0.85;173;0
"ГБУЗ ""ГБ Г. КРОПОТКИНА"" МЗ КК";врач-терапевт участковый;14.25;1995;1904;1807;97;0.91;1751;1
"ГБУЗ ""КЦРБ"" МЗ КК";врач - детский хирург;1;85;178;178;0;2.09;0;0
"ГБУЗ ""КЦРБ"" МЗ КК";врач общей практики (семейный врач);0.25;32;126;126;0;3.94;44;0
"ГБУЗ ""КЦРБ"" МЗ КК";врач-акушер-гинеколог;4.25;467;476;351;125;0.75;441;0
"ГБУЗ ""КЦРБ"" МЗ КК";врач-офтальмолог;0.5;85;54;0;54;0;54;0
"ГБУЗ ""КЦРБ"" МЗ КК";врач-педиатр участковый;7.75;1085;1298;1222;76;1.13;761;0
"ГБУЗ ""КЦРБ"" МЗ КК";врач-психиатр-нарколог;1.25;106;150;150;0;1.42;9;0
"ГБУЗ ""КЦРБ"" МЗ КК";врач-стоматолог;3;135;77;71;6;0.53;28;0
"ГБУЗ ""КЦРБ"" МЗ КК";врач-стоматолог детский;0;0;15;15;0;0;11;0
"ГБУЗ ""КЦРБ"" МЗ КК";врач-терапевт участковый;8.75;1225;995;790;205;0.64;899;0
"ГБУЗ ""КЦРБ"" МЗ КК";врач-фтизиатр участковый;2;110;115;115;0;1.05;64;0
"ГБУЗ ""КЦРБ"" МЗ КК";врач-хирург;1.25;106;65;30;35;0.28;65;0
"ГБУЗ ""ПТД № 4""";врач-фтизиатр;0;0;50;45;5;0;48;0
"ГБУЗ ""ПТД № 4""";врач-фтизиатр участковый;6.25;343;388;360;28;1.05;192;1
"ГБУЗ ""КАЛИНИНСКАЯ ЦРБ"" МЗ КК";врач - детский хирург;0.25;21;0;0;0;0;0;1
"ГБУЗ ""КАЛИНИНСКАЯ ЦРБ"" МЗ КК";врач общей практики (семейный врач);7.75;1007;550;549;1;0.55;327;3
"ГБУЗ ""КАЛИНИНСКАЯ ЦРБ"" МЗ КК";врач-акушер-гинеколог;2;220;183;103;80;0.47;183;1
"ГБУЗ ""КАЛИНИНСКАЯ ЦРБ"" МЗ КК";врач-оториноларинголог;1;150;61;50;11;0.33;42;0
"ГБУЗ ""КАЛИНИНСКАЯ ЦРБ"" МЗ КК";врач-офтальмолог;1.25;212;126;122;4;0.58;114;1
"ГБУЗ ""КАЛИНИНСКАЯ ЦРБ"" МЗ КК";врач-педиатр участковый;5;700;723;665;58;0.95;541;0
"ГБУЗ ""КАЛИНИНСКАЯ ЦРБ"" МЗ КК";врач-психиатр-нарколог;0.75;63;0;0;0;0;0;2
"ГБУЗ ""КАЛИНИНСКАЯ ЦРБ"" МЗ КК";врач-психиатр-нарколог участковый;0;0;44;44;0;0;43;0
"ГБУЗ ""КАЛИНИНСКАЯ ЦРБ"" МЗ КК";врач-стоматолог;3;135;115;86;29;0.64;115;1
"ГБУЗ ""КАЛИНИНСКАЯ ЦРБ"" МЗ КК";врач-стоматолог детский;0;0;5;0;5;0;5;0
"ГБУЗ ""КАЛИНИНСКАЯ ЦРБ"" МЗ КК";врач-стоматолог-терапевт;1;45;50;39;11;0.87;49;0
"ГБУЗ ""КАЛИНИНСКАЯ ЦРБ"" МЗ КК";врач-терапевт участковый;4.5;630;506;457;49;0.73;426;2
"ГБУЗ ""КАЛИНИНСКАЯ ЦРБ"" МЗ КК";врач-фтизиатр участковый;1.25;68;67;57;10;0.84;30;0
"ГБУЗ ""КАЛИНИНСКАЯ ЦРБ"" МЗ КК";врач-хирург;1.25;106;56;0;56;0;56;1
ГБУЗ КАНЕВСКАЯ ЦРБ МЗ КК;врач - детский хирург;0.75;63;151;148;3;2.35;151;0
ГБУЗ КАНЕВСКАЯ ЦРБ МЗ КК;врач общей практики (семейный врач);1.5;195;261;246;15;1.26;101;0
ГБУЗ КАНЕВСКАЯ ЦРБ МЗ КК;врач-акушер-гинеколог;5.75;632;637;375;262;0.59;621;0
ГБУЗ КАНЕВСКАЯ ЦРБ МЗ КК;врач-оториноларинголог;2;300;323;319;4;1.06;281;0
ГБУЗ КАНЕВСКАЯ ЦРБ МЗ КК;врач-офтальмолог;1.25;212;105;105;0;0.5;0;1
ГБУЗ КАНЕВСКАЯ ЦРБ МЗ КК;врач-педиатр участковый;16.75;2345;2337;2307;30;0.98;1715;2
ГБУЗ КАНЕВСКАЯ ЦРБ МЗ КК;врач-психиатр детский;1;85;108;107;1;1.26;86;0
ГБУЗ КАНЕВСКАЯ ЦРБ МЗ КК;врач-психиатр-нарколог;2;170;296;296;0;1.74;6;0
ГБУЗ КАНЕВСКАЯ ЦРБ МЗ КК;врач-терапевт участковый;25.5;3570;3178;3043;135;0.85;2779;0
ГБУЗ КАНЕВСКАЯ ЦРБ МЗ КК;врач-фтизиатр участковый;2.5;137;124;124;0;0.91;117;0
ГБУЗ КАНЕВСКАЯ ЦРБ МЗ КК;врач-хирург;1;84;80;38;42;0.45;79;1
"ГБУЗ ""КОРЕНОВСКАЯ ЦРБ"" МЗ КК";врач - детский хирург;0.5;42;36;6;30;0.14;36;1
"ГБУЗ ""КОРЕНОВСКАЯ ЦРБ"" МЗ КК";врач общей практики (семейный врач);2;260;484;464;20;1.78;163;0
"ГБУЗ ""КОРЕНОВСКАЯ ЦРБ"" МЗ КК";врач-акушер-гинеколог;5;550;651;544;107;0.99;517;0
"ГБУЗ ""КОРЕНОВСКАЯ ЦРБ"" МЗ КК";врач-оториноларинголог;1.5;225;178;170;8;0.76;125;0
"ГБУЗ ""КОРЕНОВСКАЯ ЦРБ"" МЗ КК";врач-офтальмолог;1;170;96;2;94;0.01;96;0
"ГБУЗ ""КОРЕНОВСКАЯ ЦРБ"" МЗ КК";врач-педиатр участковый;10.25;1435;1633;1538;95;1.07;535;0
"ГБУЗ ""КОРЕНОВСКАЯ ЦРБ"" МЗ КК";врач-психиатр детский;1;85;85;72;13;0.85;78;0
"ГБУЗ ""КОРЕНОВСКАЯ ЦРБ"" МЗ КК";врач-психиатр-нарколог;1.25;106;40;40;0;0.38;6;0
"ГБУЗ ""КОРЕНОВСКАЯ ЦРБ"" МЗ КК";врач-стоматолог;6;269;336;261;75;0.97;296;0
"ГБУЗ ""КОРЕНОВСКАЯ ЦРБ"" МЗ КК";врач-стоматолог детский;4;180;250;115;135;0.64;248;0
"ГБУЗ ""КОРЕНОВСКАЯ ЦРБ"" МЗ КК";врач-стоматолог-терапевт;2;90;127;125;2;1.39;57;0
"ГБУЗ ""КОРЕНОВСКАЯ ЦРБ"" МЗ КК";врач-терапевт участковый;13.5;1890;1610;1376;234;0.73;1161;3
"ГБУЗ ""КОРЕНОВСКАЯ ЦРБ"" МЗ КК";врач-фтизиатр участковый;2;110;106;106;0;0.96;3;0
"ГБУЗ ""КОРЕНОВСКАЯ ЦРБ"" МЗ КК";врач-хирург;0.75;63;80;57;23;0.9;65;0
"ГБУЗ ""КРАСНОАРМЕЙСКАЯ ЦРБ""";врач - детский хирург;0.25;21;20;0;20;0;20;0
"ГБУЗ ""КРАСНОАРМЕЙСКАЯ ЦРБ""";врач общей практики (семейный врач);1;130;140;140;0;1.08;0;0
"ГБУЗ ""КРАСНОАРМЕЙСКАЯ ЦРБ""";врач-акушер-гинеколог;7.25;797;806;680;126;0.85;533;0
"ГБУЗ ""КРАСНОАРМЕЙСКАЯ ЦРБ""";врач-оториноларинголог;3;450;360;228;132;0.51;248;0
"ГБУЗ ""КРАСНОАРМЕЙСКАЯ ЦРБ""";врач-офтальмолог;2;340;287;179;108;0.53;284;1
"ГБУЗ ""КРАСНОАРМЕЙСКАЯ ЦРБ""";врач-педиатр участковый;20;2800;2758;2681;77;0.96;1461;1
"ГБУЗ ""КРАСНОАРМЕЙСКАЯ ЦРБ""";врач-психиатр детский;0;0;60;60;0;0;60;0
"ГБУЗ ""КРАСНОАРМЕЙСКАЯ ЦРБ""";врач-психиатр-нарколог;0.5;42;165;165;0;3.93;6;0
"ГБУЗ ""КРАСНОАРМЕЙСКАЯ ЦРБ""";врач-психиатр-нарколог участковый;1;85;0;0;0;0;0;1
"ГБУЗ ""КРАСНОАРМЕЙСКАЯ ЦРБ""";врач-стоматолог;11.75;528;817;783;34;1.48;322;0
"ГБУЗ ""КРАСНОАРМЕЙСКАЯ ЦРБ""";врач-стоматолог-терапевт;1;45;16;16;0;0.36;4;0
"ГБУЗ ""КРАСНОАРМЕЙСКАЯ ЦРБ""";врач-терапевт участковый;18.75;2625;2843;2554;289;0.97;2054;1
"ГБУЗ ""КРАСНОАРМЕЙСКАЯ ЦРБ""";врач-фтизиатр участковый;2;110;2;0;2;0;2;1
"ГБУЗ ""КРАСНОАРМЕЙСКАЯ ЦРБ""";врач-хирург;2.5;212;285;237;48;1.12;229;0
"ГАУЗ ""СТОМАТОЛОГИЧЕСКАЯ ПОЛИКЛИНИКА № 2"" МЗ КК";врач-стоматолог;8;359;273;187;86;0.52;273;3
"ГАУЗ ""СТОМАТОЛОГИЧЕСКАЯ ПОЛИКЛИНИКА № 2"" МЗ КК";врач-стоматолог-терапевт;6;269;10;0;10;0;10;5
"ГБУЗ ""ГБ № 2 Г. КРАСНОДАРА"" МЗ КК";врач-акушер-гинеколог;0;0;163;0;163;0;163;0
"ГБУЗ ""ГБ № 2 Г. КРАСНОДАРА"" МЗ КК";врач-оториноларинголог;1.75;262;249;238;11;0.91;120;0
"ГБУЗ ""ГБ № 2 Г. КРАСНОДАРА"" МЗ КК";врач-офтальмолог;2.5;424;404;345;59;0.81;348;0
"ГБУЗ ""ГБ № 2 Г. КРАСНОДАРА"" МЗ КК";врач-стоматолог-терапевт;2;90;100;85;15;0.94;79;0
"ГБУЗ ""ГБ № 2 Г. КРАСНОДАРА"" МЗ КК";врач-терапевт участковый;19.25;2695;2714;2436;278;0.9;1637;0
"ГБУЗ ""ГБ № 2 Г. КРАСНОДАРА"" МЗ КК";врач-хирург;2.5;212;214;178;36;0.84;213;0
"ГБУЗ ""ГОРОДСКАЯ ПОЛИКЛИНИКА № 9 Г. КРАСНОДАРА""";врач-акушер-гинеколог;0.5;55;35;0;35;0;35;0
"ГБУЗ ""ГОРОДСКАЯ ПОЛИКЛИНИКА № 9 Г. КРАСНОДАРА""";врач-оториноларинголог;2;300;300;180;120;0.6;300;0
"ГБУЗ ""ГОРОДСКАЯ ПОЛИКЛИНИКА № 9 Г. КРАСНОДАРА""";врач-офтальмолог;0.5;85;86;51;35;0.6;85;0
"ГБУЗ ""ГОРОДСКАЯ ПОЛИКЛИНИКА № 9 Г. КРАСНОДАРА""";врач-стоматолог-терапевт;3;134;153;118;35;0.88;123;0
"ГБУЗ ""ГОРОДСКАЯ ПОЛИКЛИНИКА № 9 Г. КРАСНОДАРА""";врач-терапевт участковый;12;1680;1737;1360;377;0.81;1622;0
"ГБУЗ ""ГОРОДСКАЯ ПОЛИКЛИНИКА № 9 Г. КРАСНОДАРА""";врач-хирург;2;170;170;100;70;0.59;165;0
"ГБУЗ ""ГП № 10 Г. КРАСНОДАРА"" МЗ КК";врач-акушер-гинеколог;1;110;124;101;23;0.92;59;0
"ГБУЗ ""ГП № 10 Г. КРАСНОДАРА"" МЗ КК";врач-оториноларинголог;2;300;310;242;68;0.81;214;0
"ГБУЗ ""ГП № 10 Г. КРАСНОДАРА"" МЗ КК";врач-офтальмолог;2;340;170;136;34;0.4;169;1
"ГБУЗ ""ГП № 10 Г. КРАСНОДАРА"" МЗ КК";врач-терапевт участковый;8.75;1225;1080;777;303;0.63;1041;0
"ГБУЗ ""ГП № 10 Г. КРАСНОДАРА"" МЗ КК";врач-хирург;1;85;78;44;34;0.52;77;0
"ГБУЗ ""ГП № 11 Г. КРАСНОДАРА"" МЗ КК";врач-акушер-гинеколог;1;110;78;0;78;0;78;0
"ГБУЗ ""ГП № 11 Г. КРАСНОДАРА"" МЗ КК";врач-оториноларинголог;1;150;120;12;108;0.08;120;0
"ГБУЗ ""ГП № 11 Г. КРАСНОДАРА"" МЗ КК";врач-офтальмолог;1;170;140;105;35;0.62;138;0
"ГБУЗ ""ГП № 11 Г. КРАСНОДАРА"" МЗ КК";врач-стоматолог;2.5;112;272;271;1;2.42;127;1
"ГБУЗ ""ГП № 11 Г. КРАСНОДАРА"" МЗ КК";врач-стоматолог-терапевт;1.5;67;168;160;8;2.39;61;0
"ГБУЗ ""ГП № 11 Г. КРАСНОДАРА"" МЗ КК";врач-терапевт участковый;18;2520;2361;1916;445;0.76;2098;0
"ГБУЗ ""ГП № 11 Г. КРАСНОДАРА"" МЗ КК";врач-хирург;1.5;127;146;85;61;0.67;146;0
"ГБУЗ ""ГП № 12 Г. КРАСНОДАРА"" МЗ КК";врач - детский хирург;0.25;21;42;42;0;2;42;0
"ГБУЗ ""ГП № 12 Г. КРАСНОДАРА"" МЗ КК";врач общей практики (семейный врач);1.25;162;185;152;33;0.94;185;0
"ГБУЗ ""ГП № 12 Г. КРАСНОДАРА"" МЗ КК";врач-акушер-гинеколог;0.75;82;32;0;32;0;32;1
"ГБУЗ ""ГП № 12 Г. КРАСНОДАРА"" МЗ КК";врач-офтальмолог;1.5;255;381;254;127;1;381;0
"ГБУЗ ""ГП № 12 Г. КРАСНОДАРА"" МЗ КК";врач-педиатр участковый;9;1260;1342;1255;87;1;1040;2
"ГБУЗ ""ГП № 12 Г. КРАСНОДАРА"" МЗ КК";врач-стоматолог;1.5;66;58;0;58;0;58;0
"ГБУЗ ""ГП № 12 Г. КРАСНОДАРА"" МЗ КК";врач-терапевт участковый;12;1680;1180;1110;70;0.66;1064;4
"ГБУЗ ""ГП № 12 Г. КРАСНОДАРА"" МЗ КК";врач-хирург;1.75;148;112;108;4;0.73;105;0
"ГБУЗ ""ГП № 13 Г. КРАСНОДАРА"" МЗ КК";врач - детский хирург;1.5;127;196;158;38;1.24;196;0
"ГБУЗ ""ГП № 13 Г. КРАСНОДАРА"" МЗ КК";врач общей практики (семейный врач);2.5;325;204;164;40;0.5;124;0
"ГБУЗ ""ГП № 13 Г. КРАСНОДАРА"" МЗ КК";врач-акушер-гинеколог;7.75;852;806;435;371;0.51;806;0
"ГБУЗ ""ГП № 13 Г. КРАСНОДАРА"" МЗ КК";врач-оториноларинголог;2;300;246;174;72;0.58;246;0
"ГБУЗ ""ГП № 13 Г. КРАСНОДАРА"" МЗ КК";врач-офтальмолог;1.5;255;198;28;170;0.11;198;0
"ГБУЗ ""ГП № 13 Г. КРАСНОДАРА"" МЗ КК";врач-педиатр участковый;18;2520;2088;1967;121;0.78;1953;5
"ГБУЗ ""ГП № 13 Г. КРАСНОДАРА"" МЗ КК";врач-стоматолог;1.5;67;23;12;11;0.18;23;1
"ГБУЗ ""ГП № 13 Г. КРАСНОДАРА"" МЗ КК";врач-стоматолог-терапевт;0;0;59;15;44;0;59;0
"ГБУЗ ""ГП № 13 Г. КРАСНОДАРА"" МЗ КК";врач-терапевт участковый;21.75;3045;2860;2539;321;0.83;2475;2
"ГБУЗ ""ГП № 13 Г. КРАСНОДАРА"" МЗ КК";врач-хирург;2;170;180;153;27;0.9;180;0
"ГБУЗ ""ГП № 14 Г. КРАСНОДАРА"" МЗ КК";врач-акушер-гинеколог;0;0;53;53;0;0;48;0
"ГБУЗ ""ГП № 14 Г. КРАСНОДАРА"" МЗ КК";врач-оториноларинголог;0.25;37;0;0;0;0;0;1
"ГБУЗ ""ГП № 14 Г. КРАСНОДАРА"" МЗ КК";врач-офтальмолог;1;170;114;99;15;0.58;114;0
"ГБУЗ ""ГП № 14 Г. КРАСНОДАРА"" МЗ КК";врач-стоматолог;0;0;40;26;14;0;40;0
"ГБУЗ ""ГП № 14 Г. КРАСНОДАРА"" МЗ КК";врач-стоматолог-терапевт;1.5;67;40;39;1;0.58;23;1
"ГБУЗ ""ГП № 14 Г. КРАСНОДАРА"" МЗ КК";врач-терапевт участковый;6.75;945;671;597;74;0.63;648;2
"ГБУЗ ""ГП № 14 Г. КРАСНОДАРА"" МЗ КК";врач-хирург;2;169;41;40;1;0.24;41;1
"ГБУЗ ""ГП № 15 Г. КРАСНОДАРА"" МЗ КК";врач-оториноларинголог;1.25;187;195;145;50;0.78;195;0
"ГБУЗ ""ГП № 15 Г. КРАСНОДАРА"" МЗ КК";врач-офтальмолог;4;680;540;337;203;0.5;524;1
"ГБУЗ ""ГП № 15 Г. КРАСНОДАРА"" МЗ КК";врач-психиатр-нарколог;0.25;21;0;0;0;0;0;1
"ГБУЗ ""ГП № 15 Г. КРАСНОДАРА"" МЗ КК";врач-стоматолог;1.5;67;24;23;1;0.34;14;1
"ГБУЗ ""ГП № 15 Г. КРАСНОДАРА"" МЗ КК";врач-стоматолог-терапевт;2.5;110;153;146;7;1.33;92;0
"ГБУЗ ""ГП № 15 Г. КРАСНОДАРА"" МЗ КК";врач-терапевт участковый;6.5;910;2815;2353;462;2.59;2003;0
"ГБУЗ ""ГП № 15 Г. КРАСНОДАРА"" МЗ КК";врач-хирург;3.5;297;317;211;106;0.71;317;0
"ГБУЗ ""ГП № 16 Г. КРАСНОДАРА"" МЗ КК";врач-оториноларинголог;1;150;96;63;33;0.42;96;0
"ГБУЗ ""ГП № 16 Г. КРАСНОДАРА"" МЗ КК";врач-офтальмолог;0.75;127;114;64;50;0.5;114;0
"ГБУЗ ""ГП № 16 Г. КРАСНОДАРА"" МЗ КК";врач-стоматолог-терапевт;2;89;56;38;18;0.43;56;0
"ГБУЗ ""ГП № 16 Г. КРАСНОДАРА"" МЗ КК";врач-терапевт участковый;28;3920;3528;3033;495;0.77;3099;1
"ГБУЗ ""ГП № 16 Г. КРАСНОДАРА"" МЗ КК";врач-хирург;3;255;344;240;104;0.94;344;0
"ГБУЗ ""ГП № 17 Г. КРАСНОДАРА"" МЗ КК";врач-акушер-гинеколог;10.75;1182;1377;771;606;0.65;1377;2
"ГБУЗ ""ГП № 17 Г. КРАСНОДАРА"" МЗ КК";врач-оториноларинголог;1;150;122;92;30;0.61;120;0
"ГБУЗ ""ГП № 17 Г. КРАСНОДАРА"" МЗ КК";врач-офтальмолог;1.25;212;204;91;113;0.43;200;0
"ГБУЗ ""ГП № 17 Г. КРАСНОДАРА"" МЗ КК";врач-стоматолог;0.25;11;0;0;0;0;0;1
"ГБУЗ ""ГП № 17 Г. КРАСНОДАРА"" МЗ КК";врач-терапевт участковый;14.5;2030;1704;1228;476;0.6;1652;1
"ГБУЗ ""ГП № 17 Г. КРАСНОДАРА"" МЗ КК";врач-хирург;2;170;203;137;66;0.81;187;0
"ГБУЗ ""ГП № 19 Г. КРАСНОДАРА"" МЗ КК";врач-акушер-гинеколог;2;220;240;238;2;1.08;155;0
"ГБУЗ ""ГП № 19 Г. КРАСНОДАРА"" МЗ КК";врач-оториноларинголог;1;150;150;133;17;0.89;149;0
"ГБУЗ ""ГП № 19 Г. КРАСНОДАРА"" МЗ КК";врач-офтальмолог;1;170;170;140;30;0.82;170;0
"ГБУЗ ""ГП № 19 Г. КРАСНОДАРА"" МЗ КК";врач-стоматолог;4;180;162;147;15;0.82;141;0
"ГБУЗ ""ГП № 19 Г. КРАСНОДАРА"" МЗ КК";врач-стоматолог-терапевт;2;89;72;67;5;0.75;39;0
"ГБУЗ ""ГП № 19 Г. КРАСНОДАРА"" МЗ КК";врач-терапевт участковый;10;1400;1326;1108;218;0.79;1218;1
"ГБУЗ ""ГП № 19 Г. КРАСНОДАРА"" МЗ КК";врач-хирург;2;170;219;203;16;1.19;196;0
"ГБУЗ ""ГП № 22 Г. КРАСНОДАРА"" МЗ КК";врач-акушер-гинеколог;2.75;302;199;147;52;0.49;180;0
"ГБУЗ ""ГП № 22 Г. КРАСНОДАРА"" МЗ КК";врач-оториноларинголог;1;150;108;83;25;0.55;60;0
"ГБУЗ ""ГП № 22 Г. КРАСНОДАРА"" МЗ КК";врач-стоматолог;2;90;66;66;0;0.73;20;0
"ГБУЗ ""ГП № 22 Г. КРАСНОДАРА"" МЗ КК";врач-стоматолог-терапевт;2;90;58;58;0;0.64;36;0
"ГБУЗ ""ГП № 22 Г. КРАСНОДАРА"" МЗ КК";врач-терапевт участковый;5;700;586;585;1;0.84;326;1
"ГБУЗ ""ГП № 22 Г. КРАСНОДАРА"" МЗ КК";врач-хирург;1;85;120;70;50;0.82;101;0
"ГБУЗ ""ГП № 23 Г. КРАСНОДАРА"" МЗ КК";врач - детский хирург;1;85;80;63;17;0.74;78;0
"ГБУЗ ""ГП № 23 Г. КРАСНОДАРА"" МЗ КК";врач общей практики (семейный врач);1;130;140;122;18;0.94;140;0
"ГБУЗ ""ГП № 23 Г. КРАСНОДАРА"" МЗ КК";врач-акушер-гинеколог;4;440;470;325;145;0.74;453;0
"ГБУЗ ""ГП № 23 Г. КРАСНОДАРА"" МЗ КК";врач-офтальмолог;1.25;212;220;200;20;0.94;189;0
"ГБУЗ ""ГП № 23 Г. КРАСНОДАРА"" МЗ КК";врач-педиатр участковый;5;700;700;602;98;0.86;642;0
"ГБУЗ ""ГП № 23 Г. КРАСНОДАРА"" МЗ КК";врач-стоматолог;1.5;67;70;49;21;0.73;70;0
"ГБУЗ ""ГП № 23 Г. КРАСНОДАРА"" МЗ КК";врач-терапевт участковый;8;1120;1088;955;133;0.85;1033;0
"ГБУЗ ""ГП № 23 Г. КРАСНОДАРА"" МЗ КК";врач-хирург;0.75;63;65;53;12;0.84;64;0
"ГБУЗ ""ГП № 25 Г. КРАСНОДАРА"" МЗ КК";врач-акушер-гинеколог;4;440;418;217;201;0.49;418;0
"ГБУЗ ""ГП № 25 Г. КРАСНОДАРА"" МЗ КК";врач-оториноларинголог;1.5;225;187;156;31;0.69;178;0
"ГБУЗ ""ГП № 25 Г. КРАСНОДАРА"" МЗ КК";врач-офтальмолог;0.75;127;139;82;57;0.65;139;0
"ГБУЗ ""ГП № 25 Г. КРАСНОДАРА"" МЗ КК";врач-стоматолог;1;44;37;26;11;0.59;36;0
"ГБУЗ ""ГП № 25 Г. КРАСНОДАРА"" МЗ КК";врач-стоматолог-терапевт;5.25;232;246;177;69;0.76;197;1
"ГБУЗ ""ГП № 25 Г. КРАСНОДАРА"" МЗ КК";врач-терапевт участковый;11.5;1610;1586;1378;208;0.86;1537;0
"ГБУЗ ""ГП № 25 Г. КРАСНОДАРА"" МЗ КК";врач-терапевт участковый цехового врачебного участка;0;0;108;54;54;0;63;0
"ГБУЗ ""ГП № 25 Г. КРАСНОДАРА"" МЗ КК";врач-хирург;2;169;204;108;96;0.64;204;0
"ГБУЗ ""ГП № 26 Г. КРАСНОДАРА"" МЗ КК";врач-акушер-гинеколог;2;220;220;76;144;0.35;220;0
"ГБУЗ ""ГП № 26 Г. КРАСНОДАРА"" МЗ КК";врач-оториноларинголог;3;450;470;313;157;0.7;309;0
"ГБУЗ ""ГП № 26 Г. КРАСНОДАРА"" МЗ КК";врач-офтальмолог;1.25;212;155;52;103;0.25;155;0
"ГБУЗ ""ГП № 26 Г. КРАСНОДАРА"" МЗ КК";врач-стоматолог;1.5;67;71;55;16;0.82;58;0
"ГБУЗ ""ГП № 26 Г. КРАСНОДАРА"" МЗ КК";врач-хирург;0.75;63;80;0;80;0;80;0
"ГБУЗ ""ГП № 27 Г.КРАСНОДАРА"" МЗ КК";врач - детский хирург;1;85;105;98;7;1.15;105;0
"ГБУЗ ""ГП № 27 Г.КРАСНОДАРА"" МЗ КК";врач общей практики (семейный врач);1;130;282;235;47;1.81;282;0
"ГБУЗ ""ГП № 27 Г.КРАСНОДАРА"" МЗ КК";врач-акушер-гинеколог;10.25;1126;1196;967;229;0.86;1134;1
"ГБУЗ ""ГП № 27 Г.КРАСНОДАРА"" МЗ КК";врач-оториноларинголог;1.5;225;315;269;46;1.2;315;0
"ГБУЗ ""ГП № 27 Г.КРАСНОДАРА"" МЗ КК";врач-офтальмолог;3;510;414;361;53;0.71;414;0
"ГБУЗ ""ГП № 27 Г.КРАСНОДАРА"" МЗ КК";врач-педиатр участковый;12.5;1750;1897;1806;91;1.03;1652;0
"ГБУЗ ""ГП № 27 Г.КРАСНОДАРА"" МЗ КК";врач-стоматолог;0.5;22;32;0;32;0;32;0
"ГБУЗ ""ГП № 27 Г.КРАСНОДАРА"" МЗ КК";врач-терапевт участковый;9.25;1295;1671;1376;295;1.06;1552;2
"ГБУЗ ""ГП № 27 Г.КРАСНОДАРА"" МЗ КК";врач-хирург;2;170;180;121;59;0.71;180;0
"ГБУЗ ""ГП № 3 ГОРОДА КРАСНОДАРА"" МЗ КК";врач-акушер-гинеколог;2;220;340;340;0;1.55;165;0
"ГБУЗ ""ГП № 3 ГОРОДА КРАСНОДАРА"" МЗ КК";врач-оториноларинголог;1.5;225;190;153;37;0.68;184;0
"ГБУЗ ""ГП № 3 ГОРОДА КРАСНОДАРА"" МЗ КК";врач-офтальмолог;1.5;255;255;241;14;0.95;255;0
"ГБУЗ ""ГП № 3 ГОРОДА КРАСНОДАРА"" МЗ КК";врач-стоматолог;1;45;45;30;15;0.67;45;0
"ГБУЗ ""ГП № 3 ГОРОДА КРАСНОДАРА"" МЗ КК";врач-терапевт участковый;22.25;3115;2985;2508;477;0.81;2409;1
"ГБУЗ ""ГП № 3 ГОРОДА КРАСНОДАРА"" МЗ КК";врач-хирург;2;170;150;104;46;0.61;150;1
"ГБУЗ ""ГП № 4 Г. КРАСНОДАРА"" МЗ КК";врач-оториноларинголог;0.5;75;98;98;0;1.31;88;0
"ГБУЗ ""ГП № 4 Г. КРАСНОДАРА"" МЗ КК";врач-офтальмолог;2;340;309;206;103;0.61;306;0
"ГБУЗ ""ГП № 4 Г. КРАСНОДАРА"" МЗ КК";врач-стоматолог-терапевт;1;45;50;50;0;1.11;25;0
"ГБУЗ ""ГП № 4 Г. КРАСНОДАРА"" МЗ КК";врач-терапевт участковый;12;1680;1727;1510;217;0.9;1494;0
"ГБУЗ ""ГП № 4 Г. КРАСНОДАРА"" МЗ КК";врач-хирург;2.5;211;219;176;43;0.83;219;0
"ГБУЗ ""ГП № 5 ГОРОДА КРАСНОДАРА"" МЗ КК";врач-акушер-гинеколог;2;220;135;0;135;0;135;0
"ГБУЗ ""ГП № 5 ГОРОДА КРАСНОДАРА"" МЗ КК";врач-оториноларинголог;1.75;262;186;171;15;0.65;168;1
"ГБУЗ ""ГП № 5 ГОРОДА КРАСНОДАРА"" МЗ КК";врач-офтальмолог;1.5;255;210;169;41;0.66;210;0
"ГБУЗ ""ГП № 5 ГОРОДА КРАСНОДАРА"" МЗ КК";врач-стоматолог-терапевт;1.25;56;40;40;0;0.71;40;0
"ГБУЗ ""ГП № 5 ГОРОДА КРАСНОДАРА"" МЗ КК";врач-терапевт участковый;10.75;1505;1729;1369;360;0.91;1603;1
"ГБУЗ ""ГП № 5 ГОРОДА КРАСНОДАРА"" МЗ КК";врач-хирург;2;169;90;70;20;0.41;90;1
"ГБУЗ ""ГП № 7 Г. КРАСНОДАРА"" МЗ КК";врач-акушер-гинеколог;0;0;165;159;6;0;102;0
"ГБУЗ ""ГП № 7 Г. КРАСНОДАРА"" МЗ КК";врач-оториноларинголог;2.5;375;318;278;40;0.74;251;0
"ГБУЗ ""ГП № 7 Г. КРАСНОДАРА"" МЗ КК";врач-офтальмолог;2.25;382;298;264;34;0.69;298;0
"ГБУЗ ""ГП № 7 Г. КРАСНОДАРА"" МЗ КК";врач-психиатр-нарколог;0.25;21;0;0;0;0;0;1
"ГБУЗ ""ГП № 7 Г. КРАСНОДАРА"" МЗ КК";врач-стоматолог;3;135;120;76;44;0.56;120;0
"ГБУЗ ""ГП № 7 Г. КРАСНОДАРА"" МЗ КК";врач-стоматолог-терапевт;1;45;40;25;15;0.56;40;0
"ГБУЗ ""ГП № 7 Г. КРАСНОДАРА"" МЗ КК";врач-терапевт участковый;24;3360;2981;2743;238;0.82;2455;0
"ГБУЗ ""ГП № 7 Г. КРАСНОДАРА"" МЗ КК";врач-хирург;2.25;190;138;112;26;0.59;138;0
"ГБУЗ ""ГП № 8 Г. КРАСНОДАРА"" МЗ КК";врач - детский хирург;0.25;21;23;15;8;0.71;12;0
"ГБУЗ ""ГП № 8 Г. КРАСНОДАРА"" МЗ КК";врач общей практики (семейный врач);3;390;312;258;54;0.66;312;0
"ГБУЗ ""ГП № 8 Г. КРАСНОДАРА"" МЗ КК";врач-акушер-гинеколог;1;110;428;242;186;2.2;374;0
"ГБУЗ ""ГП № 8 Г. КРАСНОДАРА"" МЗ КК";врач-оториноларинголог;1;150;120;97;23;0.65;118;0
"ГБУЗ ""ГП № 8 Г. КРАСНОДАРА"" МЗ КК";врач-офтальмолог;0.5;85;81;50;31;0.59;63;0
"ГБУЗ ""ГП № 8 Г. КРАСНОДАРА"" МЗ КК";врач-педиатр участковый;8;1120;1169;1157;12;1.03;860;0
"ГБУЗ ""ГП № 8 Г. КРАСНОДАРА"" МЗ КК";врач-стоматолог;1;45;0;0;0;0;0;1
"ГБУЗ ""ГП № 8 Г. КРАСНОДАРА"" МЗ КК";врач-стоматолог-терапевт;3;135;145;73;72;0.54;145;0
"ГБУЗ ""ГП № 8 Г. КРАСНОДАРА"" МЗ КК";врач-терапевт участковый;9;1260;1104;787;317;0.62;1090;1
"ГБУЗ ""ГП № 8 Г. КРАСНОДАРА"" МЗ КК";врач-хирург;1;85;106;68;38;0.8;101;0
"ГБУЗ ""ДГП Г. КРАСНОДАРА № 5"" МЗ КК";врач - детский хирург;1.25;106;227;129;98;1.22;210;0
"ГБУЗ ""ДГП Г. КРАСНОДАРА № 5"" МЗ КК";врач-оториноларинголог;0.5;75;62;44;18;0.59;59;0
"ГБУЗ ""ДГП Г. КРАСНОДАРА № 5"" МЗ КК";врач-офтальмолог;1.25;212;232;155;77;0.73;222;0
"ГБУЗ ""ДГП Г. КРАСНОДАРА № 5"" МЗ КК";врач-педиатр участковый;18.25;2555;2621;2407;214;0.94;2309;0
"ГБУЗ ""ДГП № 1 Г. КРАСНОДАРА""";врач - детский хирург;2.25;191;268;216;52;1.13;267;0
"ГБУЗ ""ДГП № 1 Г. КРАСНОДАРА""";врач-акушер-гинеколог;0.25;27;32;32;0;1.19;26;0
"ГБУЗ ""ДГП № 1 Г. КРАСНОДАРА""";врач-оториноларинголог;2.25;337;368;235;133;0.7;348;0
"ГБУЗ ""ДГП № 1 Г. КРАСНОДАРА""";врач-офтальмолог;2.75;467;385;246;139;0.53;366;0
"ГБУЗ ""ДГП № 1 Г. КРАСНОДАРА""";врач-педиатр участковый;17.25;2415;2702;2156;546;0.89;2164;1
"ГБУЗ ""ДГП № 4 Г. КРАСНОДАРА"" МЗ КК";врач - детский хирург;0.25;21;41;25;16;1.19;41;0
"ГБУЗ ""ДГП № 4 Г. КРАСНОДАРА"" МЗ КК";врач-акушер-гинеколог;0.5;55;64;64;0;1.16;27;0
"ГБУЗ ""ДГП № 4 Г. КРАСНОДАРА"" МЗ КК";врач-оториноларинголог;1;150;150;140;10;0.93;105;0
"ГБУЗ ""ДГП № 4 Г. КРАСНОДАРА"" МЗ КК";врач-педиатр участковый;12;1680;1865;1726;139;1.03;1255;0
"ГБУЗ ""ДГП № 4 Г. КРАСНОДАРА"" МЗ КК";врач-хирург;0;0;54;54;0;0;37;0
"ГБУЗ ""ДГП № 6 Г. КРАСНОДАРА"" МЗ КК";врач - детский хирург;0.75;63;99;45;54;0.71;99;0
"ГБУЗ ""ДГП № 6 Г. КРАСНОДАРА"" МЗ КК";врач-офтальмолог;0.5;85;60;14;46;0.16;60;0
"ГБУЗ ""ДГП № 6 Г. КРАСНОДАРА"" МЗ КК";врач-педиатр участковый;17.5;2450;2720;2526;194;1.03;1516;0
"ГБУЗ ""ДГП № 7 Г. КРАСНОДАРА"" МЗ КК";врач - детский хирург;2;170;237;182;55;1.07;233;0
"ГБУЗ ""ДГП № 7 Г. КРАСНОДАРА"" МЗ КК";врач-акушер-гинеколог;1;110;116;96;20;0.87;113;0
"ГБУЗ ""ДГП № 7 Г. КРАСНОДАРА"" МЗ КК";врач-оториноларинголог;1.5;224;192;164;28;0.73;159;1
"ГБУЗ ""ДГП № 7 Г. КРАСНОДАРА"" МЗ КК";врач-педиатр участковый;17.5;2450;2833;2648;185;1.08;1878;1
"ГБУЗ ""ДГП № 8 Г. КРАСНОДАРА"" МЗ КК";врач - детский хирург;1;84;118;112;6;1.33;118;1
"ГБУЗ ""ДГП № 8 Г. КРАСНОДАРА"" МЗ КК";врач-акушер-гинеколог;1;110;115;95;20;0.86;106;0
"ГБУЗ ""ДГП № 8 Г. КРАСНОДАРА"" МЗ КК";врач-оториноларинголог;0.5;74;94;68;26;0.92;94;0
"ГБУЗ ""ДГП № 8 Г. КРАСНОДАРА"" МЗ КК";врач-офтальмолог;0.5;85;60;56;4;0.66;60;0
"ГБУЗ ""ДГП № 8 Г. КРАСНОДАРА"" МЗ КК";врач-педиатр участковый;18.25;2555;2438;2104;334;0.82;1968;1
"ГБУЗ ""ДГП № 9 Г. КРАСНОДАРА"" МЗ КК";врач - детский хирург;0.25;21;59;52;7;2.48;53;0
"ГБУЗ ""ДГП № 9 Г. КРАСНОДАРА"" МЗ КК";врач-акушер-гинеколог;0.5;55;74;69;5;1.25;36;0
"ГБУЗ ""ДГП № 9 Г. КРАСНОДАРА"" МЗ КК";врач-оториноларинголог;1.5;225;250;144;106;0.64;238;0
"ГБУЗ ""ДГП № 9 Г. КРАСНОДАРА"" МЗ КК";врач-офтальмолог;2;340;294;284;10;0.84;140;0
"ГБУЗ ""ДГП № 9 Г. КРАСНОДАРА"" МЗ КК";врач-педиатр участковый;7;980;992;675;317;0.69;919;0
"ГБУЗ ""ДГСП № 2 Г. КРАСНОДАР"" МЗ КК";врач-стоматолог;5.75;256;152;85;67;0.33;152;4
"ГБУЗ ""ДГСП № 2 Г. КРАСНОДАР"" МЗ КК";врач-стоматолог детский;12.5;561;739;586;153;1.04;389;4
"ГБУЗ ""ДЕТСКАЯ СТОМАТОЛОГИЧЕСКАЯ ПОЛИКЛИНИКА № 1"" МЗ КК";врач-стоматолог;1;45;20;20;0;0.44;20;0
"ГБУЗ ""ДЕТСКАЯ СТОМАТОЛОГИЧЕСКАЯ ПОЛИКЛИНИКА № 1"" МЗ КК";врач-стоматолог детский;8.75;391;432;345;87;0.88;429;1
"ГБУЗ ""ДП № 2 Г. КРАСНОДАРА"" МЗ КК";врач - детский хирург;2.25;191;345;240;105;1.26;311;0
"ГБУЗ ""ДП № 2 Г. КРАСНОДАРА"" МЗ КК";врач-акушер-гинеколог;0.5;55;63;59;4;1.07;46;0
"ГБУЗ ""ДП № 2 Г. КРАСНОДАРА"" МЗ КК";врач-оториноларинголог;2;300;288;148;140;0.49;282;0
"ГБУЗ ""ДП № 2 Г. КРАСНОДАРА"" МЗ КК";врач-офтальмолог;2.25;382;387;238;149;0.62;385;0
"ГБУЗ ""ДП № 2 Г. КРАСНОДАРА"" МЗ КК";врач-педиатр участковый;29.5;4130;4408;4166;242;1.01;3503;2
"ГБУЗ ""КБ № 3""";врач-оториноларинголог;1;149;0;0;0;0;0;3
"ГБУЗ ""ККБ № 2""";врач-акушер-гинеколог;21;2308;2401;1971;430;0.85;2068;0
"ГБУЗ ""НИИ - ККБ № 1""";врач-оториноларинголог;0.5;75;0;0;0;0;0;1
"ГБУЗ ""НИИ - ККБ № 1""";врач-офтальмолог;1;170;130;101;29;0.59;126;0
"ГБУЗ ""НИИ - ККБ № 1""";врач-терапевт участковый;14;1960;1710;1527;183;0.78;1586;0
"ГБУЗ ""НИИ - ККБ № 1""";врач-фтизиатр;0;0;5;0;5;0;5;0
"ГБУЗ ""НИИ - ККБ № 1""";врач-хирург;1;85;107;78;29;0.92;107;0
"ГБУЗ ""СТАРОКОРСУНСКАЯ УБ"" МЗ КК";врач-акушер-гинеколог;2;220;248;189;59;0.86;222;0
"ГБУЗ ""СТАРОКОРСУНСКАЯ УБ"" МЗ КК";врач-оториноларинголог;1;150;133;37;96;0.25;133;0
"ГБУЗ ""СТАРОКОРСУНСКАЯ УБ"" МЗ КК";врач-офтальмолог;1;170;199;175;24;1.03;168;0
"ГБУЗ ""СТАРОКОРСУНСКАЯ УБ"" МЗ КК";врач-педиатр участковый;3;420;308;292;16;0.7;256;0
"ГБУЗ ""СТАРОКОРСУНСКАЯ УБ"" МЗ КК";врач-терапевт участковый;5;700;467;444;23;0.63;409;0
"ГБУЗ ""СТАРОКОРСУНСКАЯ УБ"" МЗ КК";врач-хирург;1;85;85;65;20;0.76;82;0
ГБУЗ ДГП № 3 Г. КРАСНОДАРА МЗ КК;врач - детский хирург;2;170;216;196;20;1.15;160;0
ГБУЗ ДГП № 3 Г. КРАСНОДАРА МЗ КК;врач-акушер-гинеколог;1.25;137;163;136;27;0.99;65;0
ГБУЗ ДГП № 3 Г. КРАСНОДАРА МЗ КК;врач-оториноларинголог;1;150;108;57;51;0.38;108;0
ГБУЗ ДГП № 3 Г. КРАСНОДАРА МЗ КК;врач-офтальмолог;1.5;255;0;0;0;0;0;2
ГБУЗ ДГП № 3 Г. КРАСНОДАРА МЗ КК;врач-педиатр участковый;19;2660;3134;3039;95;1.14;1514;0
ГБУЗ ДСП;врач-стоматолог;2.5;111;38;17;21;0.15;38;1
ГБУЗ ДСП;врач-стоматолог детский;12.75;570;856;705;151;1.24;855;1
ГБУЗ КПТД;врач-акушер-гинеколог;1;110;50;0;50;0;50;0
ГБУЗ КПТД;врач-офтальмолог;1.5;255;5;0;5;0;5;1
ГБУЗ КПТД;врач-фтизиатр;13.5;740;405;0;405;0;405;5
ГБУЗ КПТД;врач-фтизиатр участковый;42;2297;2203;1797;406;0.78;1229;2
ГБУЗ НД;врач-психиатр детский;1;85;165;165;0;1.94;1;0
ГБУЗ НД;врач-психиатр детский участковый;1.25;106;130;130;0;1.23;101;1
ГБУЗ НД;врач-психиатр подростковый участковый;0;0;15;15;0;0;1;0
ГБУЗ НД;врач-психиатр-нарколог;32.25;2734;3877;3877;0;1.42;144;3
ГБУЗ РОДДОМ Г. КРАСНОДАРА МЗ КК;врач-акушер-гинеколог;54.25;5965;6073;4966;1107;0.83;5003;0
ГБУЗ РОДДОМ Г. КРАСНОДАРА МЗ КК;врач-стоматолог-терапевт;3.5;157;191;191;0;1.22;83;1
ГБУЗ СП № 1;врач-стоматолог;3;134;103;62;41;0.46;95;1
ГБУЗ СП № 2;врач-стоматолог-терапевт;13.25;592;518;382;136;0.65;479;1
ГБУЗ СП № 3;врач-стоматолог;5.25;233;0;0;0;0;0;8
ГБУЗ СП № 4;врач-стоматолог-терапевт;13.75;616;499;484;15;0.79;474;1
"ГБУЗ ""КРЫЛОВСКАЯ ЦРБ"" МЗ КК";врач - детский хирург;0.5;42;69;69;0;1.64;37;0
"ГБУЗ ""КРЫЛОВСКАЯ ЦРБ"" МЗ КК";врач общей практики (семейный врач);2;260;190;190;0;0.73;100;0
"ГБУЗ ""КРЫЛОВСКАЯ ЦРБ"" МЗ КК";врач-акушер-гинеколог;2.5;275;431;403;28;1.47;236;0
"ГБУЗ ""КРЫЛОВСКАЯ ЦРБ"" МЗ КК";врач-оториноларинголог;0.5;74;60;60;0;0.81;12;0
"ГБУЗ ""КРЫЛОВСКАЯ ЦРБ"" МЗ КК";врач-офтальмолог;1;170;125;65;60;0.38;125;0
"ГБУЗ ""КРЫЛОВСКАЯ ЦРБ"" МЗ КК";врач-педиатр участковый;3.75;525;461;353;108;0.67;390;0
"ГБУЗ ""КРЫЛОВСКАЯ ЦРБ"" МЗ КК";врач-психиатр-нарколог;1.5;127;75;75;0;0.59;1;1
"ГБУЗ ""КРЫЛОВСКАЯ ЦРБ"" МЗ КК";врач-стоматолог;3.5;156;350;350;0;2.24;0;2
"ГБУЗ ""КРЫЛОВСКАЯ ЦРБ"" МЗ КК";врач-стоматолог детский;1;45;0;0;0;0;0;1
"ГБУЗ ""КРЫЛОВСКАЯ ЦРБ"" МЗ КК";врач-терапевт участковый;9.75;1365;620;543;77;0.4;383;2
"ГБУЗ ""КРЫЛОВСКАЯ ЦРБ"" МЗ КК";врач-фтизиатр участковый;1.25;68;0;0;0;0;0;1
"ГБУЗ ""КРЫЛОВСКАЯ ЦРБ"" МЗ КК";врач-хирург;0.75;63;30;30;0;0.48;26;0
"ГБУЗ ""КРЫМСКАЯ ЦРБ"" МЗ КК";врач - детский хирург;1.5;127;187;121;66;0.95;187;0
"ГБУЗ ""КРЫМСКАЯ ЦРБ"" МЗ КК";врач общей практики (семейный врач);5.75;747;959;946;13;1.27;419;1
"ГБУЗ ""КРЫМСКАЯ ЦРБ"" МЗ КК";врач-акушер-гинеколог;11;1208;1176;935;241;0.77;883;1
"ГБУЗ ""КРЫМСКАЯ ЦРБ"" МЗ КК";врач-оториноларинголог;3.5;524;604;573;31;1.09;474;0
"ГБУЗ ""КРЫМСКАЯ ЦРБ"" МЗ КК";врач-офтальмолог;1.5;254;297;215;82;0.85;297;0
"ГБУЗ ""КРЫМСКАЯ ЦРБ"" МЗ КК";врач-педиатр участковый;16.5;2310;2852;2604;248;1.13;1233;1
"ГБУЗ ""КРЫМСКАЯ ЦРБ"" МЗ КК";врач-психиатр детский;2;170;85;62;23;0.36;70;1
"ГБУЗ ""КРЫМСКАЯ ЦРБ"" МЗ КК";врач-психиатр детский участковый;0;0;85;78;7;0;66;0
"ГБУЗ ""КРЫМСКАЯ ЦРБ"" МЗ КК";врач-психиатр-нарколог;0.5;42;175;175;0;4.17;21;0
"ГБУЗ ""КРЫМСКАЯ ЦРБ"" МЗ КК";врач-стоматолог;4.25;190;310;295;15;1.55;61;3
"ГБУЗ ""КРЫМСКАЯ ЦРБ"" МЗ КК";врач-стоматолог детский;0;0;25;25;0;0;17;0
"ГБУЗ ""КРЫМСКАЯ ЦРБ"" МЗ КК";врач-стоматолог-терапевт;0;0;135;135;0;0;36;0
"ГБУЗ ""КРЫМСКАЯ ЦРБ"" МЗ КК";врач-терапевт участковый;30;4200;4973;4850;123;1.15;2857;1
"ГБУЗ ""КРЫМСКАЯ ЦРБ"" МЗ КК";врач-хирург;3.25;274;329;303;26;1.11;239;0
"ГАУЗ ""КРСП"" МЗ КК";врач-стоматолог;6.75;303;497;434;63;1.43;402;0
"ГАУЗ ""КРСП"" МЗ КК";врач-стоматолог детский;1;45;150;150;0;3.33;105;1
"ГАУЗ ""КРСП"" МЗ КК";врач-стоматолог-терапевт;5.5;246;160;120;40;0.49;136;1
"ГБУЗ ""КУРГАНИНСКАЯ ЦРБ"" МЗ КК";врач - детский хирург;1.1;93;114;110;4;1.18;114;0
"ГБУЗ ""КУРГАНИНСКАЯ ЦРБ"" МЗ КК";врач общей практики (семейный врач);1;130;130;130;0;1;69;0
"ГБУЗ ""КУРГАНИНСКАЯ ЦРБ"" МЗ КК";врач-акушер-гинеколог;7;769;836;649;187;0.84;606;0
"ГБУЗ ""КУРГАНИНСКАЯ ЦРБ"" МЗ КК";врач-оториноларинголог;1.25;187;179;97;82;0.52;179;0
"ГБУЗ ""КУРГАНИНСКАЯ ЦРБ"" МЗ КК";врач-офтальмолог;1.25;212;164;87;77;0.41;164;0
"ГБУЗ ""КУРГАНИНСКАЯ ЦРБ"" МЗ КК";врач-педиатр участковый;15;2100;2103;1782;321;0.85;1271;1
"ГБУЗ ""КУРГАНИНСКАЯ ЦРБ"" МЗ КК";врач-психиатр-нарколог;1.5;127;0;0;0;0;0;1
"ГБУЗ ""КУРГАНИНСКАЯ ЦРБ"" МЗ КК";врач-стоматолог детский;0.25;11;20;0;20;0;20;0
"ГБУЗ ""КУРГАНИНСКАЯ ЦРБ"" МЗ КК";врач-терапевт участковый;16.75;2345;1953;1753;200;0.75;1232;2
"ГБУЗ ""КУРГАНИНСКАЯ ЦРБ"" МЗ КК";врач-хирург;2.5;212;216;199;17;0.94;216;0
"ГАУЗ ""КУЩЕВСКАЯ СТОМАТОЛОГИЧЕСКАЯ ПОЛИКЛИНИКА"" МЗ КК";врач-стоматолог;8.5;378;517;516;1;1.37;335;0
"ГАУЗ ""КУЩЕВСКАЯ СТОМАТОЛОГИЧЕСКАЯ ПОЛИКЛИНИКА"" МЗ КК";врач-стоматолог детский;1;45;100;84;16;1.87;100;0
"ГАУЗ ""КУЩЕВСКАЯ СТОМАТОЛОГИЧЕСКАЯ ПОЛИКЛИНИКА"" МЗ КК";врач-стоматолог-терапевт;1.5;67;96;96;0;1.43;51;0
"ГБУЗ ""КУЩЕВСКАЯ ЦРБ"" МЗ КК";врач - детский хирург;1;85;200;196;4;2.31;170;0
"ГБУЗ ""КУЩЕВСКАЯ ЦРБ"" МЗ КК";врач общей практики (семейный врач);8.75;1136;1598;1598;0;1.41;544;0
"ГБУЗ ""КУЩЕВСКАЯ ЦРБ"" МЗ КК";врач-акушер-гинеколог;2.25;247;449;391;58;1.58;355;0
"ГБУЗ ""КУЩЕВСКАЯ ЦРБ"" МЗ КК";врач-оториноларинголог;1.25;187;210;206;4;1.1;150;0
"ГБУЗ ""КУЩЕВСКАЯ ЦРБ"" МЗ КК";врач-офтальмолог;4;680;809;805;4;1.18;433;0
"ГБУЗ ""КУЩЕВСКАЯ ЦРБ"" МЗ КК";врач-педиатр участковый;13;1820;2212;2206;6;1.21;1208;0
"ГБУЗ ""КУЩЕВСКАЯ ЦРБ"" МЗ КК";врач-психиатр детский;0.25;21;32;24;8;1.14;32;0
"ГБУЗ ""КУЩЕВСКАЯ ЦРБ"" МЗ КК";врач-психиатр-нарколог;1;85;120;120;0;1.41;1;0
"ГБУЗ ""КУЩЕВСКАЯ ЦРБ"" МЗ КК";врач-терапевт участковый;14.25;1995;1761;1736;25;0.87;1313;1
"ГБУЗ ""КУЩЕВСКАЯ ЦРБ"" МЗ КК";врач-хирург;2;170;381;379;2;2.23;357;0
"ГАУЗ ""ЛАБИНСКАЯ СТОМАТОЛОГИЧЕСКАЯ ПОЛИКЛИНИКА"" МЗ КК";врач-стоматолог;4.25;189;410;402;8;2.13;191;0
"ГАУЗ ""ЛАБИНСКАЯ СТОМАТОЛОГИЧЕСКАЯ ПОЛИКЛИНИКА"" МЗ КК";врач-стоматолог детский;4;179;201;128;73;0.72;201;0
"ГАУЗ ""ЛАБИНСКАЯ СТОМАТОЛОГИЧЕСКАЯ ПОЛИКЛИНИКА"" МЗ КК";врач-стоматолог-терапевт;6;267;367;323;44;1.21;330;0
"ГБУЗ ""ЛАБИНСКАЯ ЦРБ"" МЗ КК";врач - детский хирург;1.25;106;200;200;0;1.89;200;1
"ГБУЗ ""ЛАБИНСКАЯ ЦРБ"" МЗ КК";врач общей практики (семейный врач);3;390;306;306;0;0.78;247;0
"ГБУЗ ""ЛАБИНСКАЯ ЦРБ"" МЗ КК";врач-акушер-гинеколог;3.75;411;430;230;200;0.56;430;0
"ГБУЗ ""ЛАБИНСКАЯ ЦРБ"" МЗ КК";врач-оториноларинголог;2.5;375;325;248;77;0.66;325;0
"ГБУЗ ""ЛАБИНСКАЯ ЦРБ"" МЗ КК";врач-офтальмолог;2;340;297;258;39;0.76;296;0
"ГБУЗ ""ЛАБИНСКАЯ ЦРБ"" МЗ КК";врач-педиатр участковый;9.15;1281;1302;1289;13;1.01;966;1
"ГБУЗ ""ЛАБИНСКАЯ ЦРБ"" МЗ КК";врач-терапевт участковый;16.25;2275;1948;1895;53;0.83;1237;1
"ГБУЗ ""ЛАБИНСКАЯ ЦРБ"" МЗ КК";врач-хирург;2.25;191;139;73;66;0.38;137;0
"ГБУЗ ""ЛЕНИНГРАДСКАЯ ЦРБ"" МЗ КК";врач - детский хирург;1;85;192;192;0;2.26;187;0
"ГБУЗ ""ЛЕНИНГРАДСКАЯ ЦРБ"" МЗ КК";врач общей практики (семейный врач);2;260;495;495;0;1.9;135;0
"ГБУЗ ""ЛЕНИНГРАДСКАЯ ЦРБ"" МЗ КК";врач-акушер-гинеколог;3;330;348;341;7;1.03;348;0
"ГБУЗ ""ЛЕНИНГРАДСКАЯ ЦРБ"" МЗ КК";врач-оториноларинголог;1.75;262;151;111;40;0.42;151;1
"ГБУЗ ""ЛЕНИНГРАДСКАЯ ЦРБ"" МЗ КК";врач-офтальмолог;2.5;425;373;348;25;0.82;368;0
"ГБУЗ ""ЛЕНИНГРАДСКАЯ ЦРБ"" МЗ КК";врач-педиатр участковый;9;1260;1321;1146;175;0.91;1074;0
"ГБУЗ ""ЛЕНИНГРАДСКАЯ ЦРБ"" МЗ КК";врач-психиатр детский;0.5;42;42;36;6;0.86;28;0
"ГБУЗ ""ЛЕНИНГРАДСКАЯ ЦРБ"" МЗ КК";врач-психиатр-нарколог;2;170;205;205;0;1.21;64;0
"ГБУЗ ""ЛЕНИНГРАДСКАЯ ЦРБ"" МЗ КК";врач-стоматолог;1.25;56;70;40;30;0.71;70;0
"ГБУЗ ""ЛЕНИНГРАДСКАЯ ЦРБ"" МЗ КК";врач-стоматолог детский;1;45;81;48;33;1.07;81;0
"ГБУЗ ""ЛЕНИНГРАДСКАЯ ЦРБ"" МЗ КК";врач-стоматолог-терапевт;3;135;203;131;72;0.97;201;0
"ГБУЗ ""ЛЕНИНГРАДСКАЯ ЦРБ"" МЗ КК";врач-терапевт участковый;12.25;1715;1258;1244;14;0.73;934;1
"ГБУЗ ""ЛЕНИНГРАДСКАЯ ЦРБ"" МЗ КК";врач-фтизиатр участковый;1;55;39;39;0;0.71;23;0
"ГБУЗ ""ЛЕНИНГРАДСКАЯ ЦРБ"" МЗ КК";врач-хирург;1;85;157;149;8;1.75;157;0
"ГБУЗ ""МОСТОВСКАЯ ЦРБ"" МЗ КК";врач - детский хирург;1;85;125;125;0;1.47;85;0
"ГБУЗ ""МОСТОВСКАЯ ЦРБ"" МЗ КК";врач общей практики (семейный врач);8.25;1072;2181;2114;67;1.97;599;1
"ГБУЗ ""МОСТОВСКАЯ ЦРБ"" МЗ КК";врач-акушер-гинеколог;3.25;357;520;458;62;1.28;314;0
"ГБУЗ ""МОСТОВСКАЯ ЦРБ"" МЗ КК";врач-оториноларинголог;2;300;292;157;135;0.52;252;0
"ГБУЗ ""МОСТОВСКАЯ ЦРБ"" МЗ КК";врач-офтальмолог;2.5;424;318;275;43;0.65;318;0
"ГБУЗ ""МОСТОВСКАЯ ЦРБ"" МЗ КК";врач-педиатр участковый;9.75;1365;1668;1575;93;1.15;1211;0
"ГБУЗ ""МОСТОВСКАЯ ЦРБ"" МЗ КК";врач-психиатр детский;0.25;21;0;0;0;0;0;1
"ГБУЗ ""МОСТОВСКАЯ ЦРБ"" МЗ КК";врач-психиатр-нарколог;1.25;106;90;90;0;0.85;0;0
"ГБУЗ ""МОСТОВСКАЯ ЦРБ"" МЗ КК";врач-стоматолог;6.5;292;920;920;0;3.15;0;1
"ГБУЗ ""МОСТОВСКАЯ ЦРБ"" МЗ КК";врач-стоматолог детский;1.25;56;60;60;0;1.07;60;1
"ГБУЗ ""МОСТОВСКАЯ ЦРБ"" МЗ КК";врач-стоматолог-терапевт;1;45;35;35;0;0.78;35;0
"ГБУЗ ""МОСТОВСКАЯ ЦРБ"" МЗ КК";врач-терапевт участковый;15.25;2135;2828;2783;45;1.3;1360;0
"ГБУЗ ""МОСТОВСКАЯ ЦРБ"" МЗ КК";врач-фтизиатр участковый;1.5;82;0;0;0;0;0;1
"ГБУЗ ""МОСТОВСКАЯ ЦРБ"" МЗ КК";врач-хирург;2;170;237;222;15;1.31;212;0
"ГБУЗ ""НОВОКУБАНСКАЯ СТОМАТОЛОГИЧЕСКАЯ ПОЛИКЛИНИКА"" МЗ КК";врач-стоматолог;17.25;774;1836;1787;49;2.31;1209;1
"ГБУЗ ""НОВОКУБАНСКАЯ СТОМАТОЛОГИЧЕСКАЯ ПОЛИКЛИНИКА"" МЗ КК";врач-стоматолог-терапевт;1;45;0;0;0;0;0;1
ГБУЗ НОВОКУБАНСКАЯ ЦРБ;врач - детский хирург;1;85;68;68;0;0.8;51;0
ГБУЗ НОВОКУБАНСКАЯ ЦРБ;врач-акушер-гинеколог;6.25;687;1043;1043;0;1.52;532;0
ГБУЗ НОВОКУБАНСКАЯ ЦРБ;врач-оториноларинголог;0.25;37;65;60;5;1.62;48;1
ГБУЗ НОВОКУБАНСКАЯ ЦРБ;врач-офтальмолог;2;340;429;425;4;1.25;253;0
ГБУЗ НОВОКУБАНСКАЯ ЦРБ;врач-педиатр участковый;17.75;2485;2339;2183;156;0.88;681;3
ГБУЗ НОВОКУБАНСКАЯ ЦРБ;врач-психиатр-нарколог;1.25;106;50;50;0;0.47;1;0
ГБУЗ НОВОКУБАНСКАЯ ЦРБ;врач-стоматолог;1;45;0;0;0;0;0;1
ГБУЗ НОВОКУБАНСКАЯ ЦРБ;врач-терапевт участковый;22;3080;2897;2755;142;0.89;789;4
ГБУЗ НОВОКУБАНСКАЯ ЦРБ;врач-фтизиатр участковый;1.75;96;10;10;0;0.1;0;1
ГБУЗ НОВОКУБАНСКАЯ ЦРБ;врач-хирург;4;340;312;297;15;0.87;222;0
"ГБУЗ ""НОВОПОКРОВСКАЯ ЦРБ"" МЗ КК";врач - детский хирург;1;85;169;119;50;1.4;129;0
"ГБУЗ ""НОВОПОКРОВСКАЯ ЦРБ"" МЗ КК";врач общей практики (семейный врач);5.25;682;625;623;2;0.91;153;0
"ГБУЗ ""НОВОПОКРОВСКАЯ ЦРБ"" МЗ КК";врач-акушер-гинеколог;1.75;192;70;62;8;0.32;52;0
"ГБУЗ ""НОВОПОКРОВСКАЯ ЦРБ"" МЗ КК";врач-оториноларинголог;1.5;225;264;264;0;1.17;121;0
"ГБУЗ ""НОВОПОКРОВСКАЯ ЦРБ"" МЗ КК";врач-офтальмолог;2;340;284;115;169;0.34;284;0
"ГБУЗ ""НОВОПОКРОВСКАЯ ЦРБ"" МЗ КК";врач-педиатр участковый;5.5;770;783;771;12;1;490;0
"ГБУЗ ""НОВОПОКРОВСКАЯ ЦРБ"" МЗ КК";врач-психиатр-нарколог;1.5;127;150;150;0;1.18;15;0
"ГБУЗ ""НОВОПОКРОВСКАЯ ЦРБ"" МЗ КК";врач-стоматолог;6;270;272;227;45;0.84;99;0
"ГБУЗ ""НОВОПОКРОВСКАЯ ЦРБ"" МЗ КК";врач-стоматолог детский;1.5;67;139;79;60;1.18;139;0
"ГБУЗ ""НОВОПОКРОВСКАЯ ЦРБ"" МЗ КК";врач-терапевт участковый;5;700;630;557;73;0.8;360;1
"ГБУЗ ""НОВОПОКРОВСКАЯ ЦРБ"" МЗ КК";врач-фтизиатр участковый;1.25;68;75;70;5;1.03;25;0
"ГБУЗ ""НОВОПОКРОВСКАЯ ЦРБ"" МЗ КК";врач-хирург;1;85;75;75;0;0.88;75;0
"ГАУЗ ""КДЦ Г.НОВОРОССИЙСКА"" МЗ КК";врач-акушер-гинеколог;1.25;137;27;25;2;0.18;27;0
"ГАУЗ ""КДЦ Г.НОВОРОССИЙСКА"" МЗ КК";врач-оториноларинголог;1.75;262;143;143;0;0.55;97;0
"ГАУЗ ""КДЦ Г.НОВОРОССИЙСКА"" МЗ КК";врач-офтальмолог;1;170;49;44;5;0.26;49;0
"ГАУЗ ""ПЦ Г. НОВОРОССИЙСКА"" МЗ КК";врач-акушер-гинеколог;7.25;796;864;647;217;0.81;760;2
"ГАУЗ ""ПЦ Г. НОВОРОССИЙСКА"" МЗ КК";врач-стоматолог-терапевт;0.25;11;0;0;0;0;0;1
"ГАУЗ ""СТОМАТОЛОГИЧЕСКАЯ ПОЛИКЛИНИКА Г.НОВОРОССИЙСКА"" МЗ КК";врач-стоматолог;11.25;505;398;213;185;0.42;397;4
"ГАУЗ ""СТОМАТОЛОГИЧЕСКАЯ ПОЛИКЛИНИКА Г.НОВОРОССИЙСКА"" МЗ КК";врач-стоматолог-терапевт;4.5;202;272;103;169;0.51;272;1
"ГБУЗ ""АМБУЛАТОРИЯ № 1 Г.НОВОРОССИЙСКА"" МЗ КК";врач - детский хирург;1;85;142;104;38;1.22;142;0
"ГБУЗ ""АМБУЛАТОРИЯ № 1 Г.НОВОРОССИЙСКА"" МЗ КК";врач общей практики (семейный врач);1;130;70;47;23;0.36;70;0
"ГБУЗ ""АМБУЛАТОРИЯ № 1 Г.НОВОРОССИЙСКА"" МЗ КК";врач-акушер-гинеколог;1;110;116;17;99;0.15;116;0
"ГБУЗ ""АМБУЛАТОРИЯ № 1 Г.НОВОРОССИЙСКА"" МЗ КК";врач-оториноларинголог;1;150;157;100;57;0.67;141;0
"ГБУЗ ""АМБУЛАТОРИЯ № 1 Г.НОВОРОССИЙСКА"" МЗ КК";врач-педиатр участковый;5.5;770;932;789;143;1.02;800;0
"ГБУЗ ""АМБУЛАТОРИЯ № 1 Г.НОВОРОССИЙСКА"" МЗ КК";врач-стоматолог;1;45;34;21;13;0.47;34;1
"ГБУЗ ""АМБУЛАТОРИЯ № 1 Г.НОВОРОССИЙСКА"" МЗ КК";врач-стоматолог-терапевт;0.5;22;0;0;0;0;0;1
"ГБУЗ ""АМБУЛАТОРИЯ № 1 Г.НОВОРОССИЙСКА"" МЗ КК";врач-терапевт участковый;6;840;678;583;95;0.69;635;3
"ГБУЗ ""АМБУЛАТОРИЯ № 1 Г.НОВОРОССИЙСКА"" МЗ КК";врач-хирург;1;85;96;87;9;1.02;96;0
"ГБУЗ ""ГБ № 2 Г. НОВОРОССИЙСКА"" МЗ КК";врач - детский хирург;1.5;127;294;215;79;1.69;294;0
"ГБУЗ ""ГБ № 2 Г. НОВОРОССИЙСКА"" МЗ КК";врач-акушер-гинеколог;4;440;359;254;105;0.58;317;1
"ГБУЗ ""ГБ № 2 Г. НОВОРОССИЙСКА"" МЗ КК";врач-оториноларинголог;1.5;225;203;96;107;0.43;203;0
"ГБУЗ ""ГБ № 2 Г. НОВОРОССИЙСКА"" МЗ КК";врач-офтальмолог;2.5;425;338;172;166;0.4;337;0
"ГБУЗ ""ГБ № 2 Г. НОВОРОССИЙСКА"" МЗ КК";врач-педиатр участковый;23.75;3325;3523;2666;857;0.8;2675;0
"ГБУЗ ""ГБ № 2 Г. НОВОРОССИЙСКА"" МЗ КК";врач-стоматолог;2;90;16;10;6;0.11;16;2
"ГБУЗ ""ГБ № 2 Г. НОВОРОССИЙСКА"" МЗ КК";врач-стоматолог-терапевт;6.25;279;416;285;131;1.02;287;1
"ГБУЗ ""ГБ № 2 Г. НОВОРОССИЙСКА"" МЗ КК";врач-терапевт участковый;15.75;2205;1706;1510;196;0.68;1618;5
"ГБУЗ ""ГБ № 2 Г. НОВОРОССИЙСКА"" МЗ КК";врач-хирург;3.5;296;118;73;45;0.25;118;3
"ГБУЗ ""ГБ № 4 Г. НОВОРОССИЙСКА"" МЗ КК";врач-акушер-гинеколог;2.5;274;270;266;4;0.97;253;0
"ГБУЗ ""ГБ № 4 Г. НОВОРОССИЙСКА"" МЗ КК";врач-офтальмолог;0.25;42;40;20;20;0.48;40;0
"ГБУЗ ""ГБ № 4 Г. НОВОРОССИЙСКА"" МЗ КК";врач-педиатр участковый;3;420;560;409;151;0.97;560;0
"ГБУЗ ""ГБ № 4 Г. НОВОРОССИЙСКА"" МЗ КК";врач-стоматолог-терапевт;0.25;11;26;0;26;0;26;1
"ГБУЗ ""ГБ № 4 Г. НОВОРОССИЙСКА"" МЗ КК";врач-терапевт участковый;3;420;489;265;224;0.63;477;0
"ГБУЗ ""ГБ № 4 Г. НОВОРОССИЙСКА"" МЗ КК";врач-хирург;0.5;42;21;17;4;0.4;21;0
"ГБУЗ ""ГОРОДСКАЯ ПОЛИКЛИНИКА № 3 Г. НОВОРОССИЙСКА"" МЗ КК";врач - детский хирург;0.25;21;60;60;0;2.86;49;0
"ГБУЗ ""ГОРОДСКАЯ ПОЛИКЛИНИКА № 3 Г. НОВОРОССИЙСКА"" МЗ КК";врач-акушер-гинеколог;0.25;27;92;60;32;2.22;79;0
"ГБУЗ ""ГОРОДСКАЯ ПОЛИКЛИНИКА № 3 Г. НОВОРОССИЙСКА"" МЗ КК";врач-оториноларинголог;0.5;75;50;39;11;0.52;50;0
"ГБУЗ ""ГОРОДСКАЯ ПОЛИКЛИНИКА № 3 Г. НОВОРОССИЙСКА"" МЗ КК";врач-офтальмолог;1;170;121;121;0;0.71;76;0
"ГБУЗ ""ГОРОДСКАЯ ПОЛИКЛИНИКА № 3 Г. НОВОРОССИЙСКА"" МЗ КК";врач-педиатр участковый;4;560;600;600;0;1.07;313;0
"ГБУЗ ""ГОРОДСКАЯ ПОЛИКЛИНИКА № 3 Г. НОВОРОССИЙСКА"" МЗ КК";врач-психиатр-нарколог;0.25;21;0;0;0;0;0;1
"ГБУЗ ""ГОРОДСКАЯ ПОЛИКЛИНИКА № 3 Г. НОВОРОССИЙСКА"" МЗ КК";врач-терапевт участковый;3.5;490;395;284;111;0.58;366;1
"ГБУЗ ""ГОРОДСКАЯ ПОЛИКЛИНИКА № 3 Г. НОВОРОССИЙСКА"" МЗ КК";врач-хирург;1;85;75;74;1;0.87;75;0
"ГБУЗ ""ГП № 1 Г. НОВОРОССИЙСКА"" МЗ КК";врач-оториноларинголог;2.25;337;294;203;91;0.6;293;1
"ГБУЗ ""ГП № 1 Г. НОВОРОССИЙСКА"" МЗ КК";врач-офтальмолог;2;340;319;200;119;0.59;295;0
"ГБУЗ ""ГП № 1 Г. НОВОРОССИЙСКА"" МЗ КК";врач-терапевт участковый;9.5;1330;1171;954;217;0.72;1155;1
"ГБУЗ ""ГП № 1 Г. НОВОРОССИЙСКА"" МЗ КК";врач-хирург;1.25;106;96;78;18;0.74;90;1
"ГБУЗ ""ГП № 2 Г. НОВОРОССИЙСКА"" МЗ КК";врач-акушер-гинеколог;1;110;125;104;21;0.95;46;0
"ГБУЗ ""ГП № 2 Г. НОВОРОССИЙСКА"" МЗ КК";врач-оториноларинголог;1;150;168;114;54;0.76;142;0
"ГБУЗ ""ГП № 2 Г. НОВОРОССИЙСКА"" МЗ КК";врач-педиатр участковый;2;280;302;254;48;0.91;215;1
"ГБУЗ ""ГП № 2 Г. НОВОРОССИЙСКА"" МЗ КК";врач-терапевт участковый;2;280;300;251;49;0.9;272;0
"ГБУЗ ""ГП № 2 Г. НОВОРОССИЙСКА"" МЗ КК";врач-хирург;0.25;21;91;67;24;3.19;82;0
"ГБУЗ ""ГП № 6 Г. НОВОРОССИЙСКА"" МЗ КК";врач - детский хирург;1;85;100;100;0;1.18;39;0
"ГБУЗ ""ГП № 6 Г. НОВОРОССИЙСКА"" МЗ КК";врач общей практики (семейный врач);0;0;260;219;41;0;191;0
"ГБУЗ ""ГП № 6 Г. НОВОРОССИЙСКА"" МЗ КК";врач-акушер-гинеколог;0;0;105;58;47;0;105;0
"ГБУЗ ""ГП № 6 Г. НОВОРОССИЙСКА"" МЗ КК";врач-офтальмолог;0.5;85;87;60;27;0.71;80;0
"ГБУЗ ""ГП № 6 Г. НОВОРОССИЙСКА"" МЗ КК";врач-педиатр участковый;2;280;420;362;58;1.29;310;0
"ГБУЗ ""ГП № 6 Г. НОВОРОССИЙСКА"" МЗ КК";врач-стоматолог;0.25;11;9;6;3;0.55;9;0
"ГБУЗ ""ГП № 6 Г. НОВОРОССИЙСКА"" МЗ КК";врач-стоматолог-терапевт;1;45;45;30;15;0.67;45;0
"ГБУЗ ""ГП № 6 Г. НОВОРОССИЙСКА"" МЗ КК";врач-терапевт участковый;2;280;489;392;97;1.4;300;0
"ГБУЗ ""ГП № 6 Г. НОВОРОССИЙСКА"" МЗ КК";врач-хирург;1;84;48;48;0;0.57;48;1
"ГБУЗ ""ГП № 7 Г.НОВОРОССИЙСКА"" МЗ КК";врач-акушер-гинеколог;1;110;60;60;0;0.55;60;0
"ГБУЗ ""ГП № 7 Г.НОВОРОССИЙСКА"" МЗ КК";врач-педиатр участковый;2;280;332;331;1;1.18;150;0
"ГБУЗ ""ГП № 7 Г.НОВОРОССИЙСКА"" МЗ КК";врач-стоматолог;1.5;67;0;0;0;0;0;1
"ГБУЗ ""ГП № 7 Г.НОВОРОССИЙСКА"" МЗ КК";врач-стоматолог-терапевт;0;0;150;150;0;0;17;0
"ГБУЗ ""ГП № 7 Г.НОВОРОССИЙСКА"" МЗ КК";врач-терапевт участковый;3;420;229;199;30;0.47;227;1
"ГБУЗ ""ГП № 7 Г.НОВОРОССИЙСКА"" МЗ КК";врач-хирург;1;85;63;63;0;0.74;38;0
"ГБУЗ ""ГП № 8 Г. НОВОРОССИЙСКА"" МЗ КК";врач-акушер-гинеколог;1;110;130;114;16;1.04;130;0
"ГБУЗ ""ГП № 8 Г. НОВОРОССИЙСКА"" МЗ КК";врач-оториноларинголог;1;150;142;142;0;0.95;72;0
"ГБУЗ ""ГП № 8 Г. НОВОРОССИЙСКА"" МЗ КК";врач-офтальмолог;0.25;42;48;0;48;0;48;0
"ГБУЗ ""ГП № 8 Г. НОВОРОССИЙСКА"" МЗ КК";врач-педиатр участковый;2.75;385;276;214;62;0.56;262;1
"ГБУЗ ""ГП № 8 Г. НОВОРОССИЙСКА"" МЗ КК";врач-стоматолог;0.75;33;70;45;25;1.36;70;0
"ГБУЗ ""ГП № 8 Г. НОВОРОССИЙСКА"" МЗ КК";врач-терапевт участковый;3;420;378;343;35;0.82;298;0
"ГБУЗ ""ГП № 8 Г. НОВОРОССИЙСКА"" МЗ КК";врач-хирург;0.25;21;27;18;9;0.86;27;0
"ГБУЗ ""ДГП Г.НОВОРОССИЙСКА"" МЗ КК";врач - детский хирург;0.75;63;50;50;0;0.79;34;0
"ГБУЗ ""ДГП Г.НОВОРОССИЙСКА"" МЗ КК";врач-акушер-гинеколог;1;110;109;108;1;0.98;66;0
"ГБУЗ ""ДГП Г.НОВОРОССИЙСКА"" МЗ КК";врач-оториноларинголог;1.25;187;188;161;27;0.86;111;0
"ГБУЗ ""ДГП Г.НОВОРОССИЙСКА"" МЗ КК";врач-офтальмолог;1;170;157;100;57;0.59;157;0
"ГБУЗ ""ДГП Г.НОВОРОССИЙСКА"" МЗ КК";врач-педиатр участковый;12;1680;1994;1803;191;1.07;1609;0
ГБУЗ ДСП Г. НОВОРОССИЙСКА МЗ КК;врач-стоматолог;3.25;146;50;32;18;0.22;50;2
ГБУЗ ДСП Г. НОВОРОССИЙСКА МЗ КК;врач-стоматолог детский;7;313;335;260;75;0.83;335;2
ГБУЗ ПТД № 23;врач-фтизиатр;0;0;33;30;3;0;29;0
ГБУЗ ПТД № 24;врач-фтизиатр участковый;14.5;792;850;826;24;1.04;525;0
"ГБУЗ ""ОТРАДНЕНСКАЯ ЦРБ"" МЗ КК";врач - детский хирург;0.25;21;0;0;0;0;0;1
"ГБУЗ ""ОТРАДНЕНСКАЯ ЦРБ"" МЗ КК";врач-акушер-гинеколог;1.5;165;165;154;11;0.93;165;0
"ГБУЗ ""ОТРАДНЕНСКАЯ ЦРБ"" МЗ КК";врач-оториноларинголог;2.5;375;284;270;14;0.72;262;0
"ГБУЗ ""ОТРАДНЕНСКАЯ ЦРБ"" МЗ КК";врач-офтальмолог;1.25;212;195;28;167;0.13;195;0
"ГБУЗ ""ОТРАДНЕНСКАЯ ЦРБ"" МЗ КК";врач-педиатр участковый;5;700;669;568;101;0.81;584;1
"ГБУЗ ""ОТРАДНЕНСКАЯ ЦРБ"" МЗ КК";врач-психиатр детский;0.25;21;0;0;0;0;0;1
"ГБУЗ ""ОТРАДНЕНСКАЯ ЦРБ"" МЗ КК";врач-психиатр-нарколог;1;85;0;0;0;0;0;1
"ГБУЗ ""ОТРАДНЕНСКАЯ ЦРБ"" МЗ КК";врач-стоматолог;4.5;202;771;771;0;3.82;0;0
"ГБУЗ ""ОТРАДНЕНСКАЯ ЦРБ"" МЗ КК";врач-стоматолог детский;1.5;67;100;100;0;1.49;99;0
"ГБУЗ ""ОТРАДНЕНСКАЯ ЦРБ"" МЗ КК";врач-стоматолог-терапевт;1;45;218;218;0;4.84;17;0
"ГБУЗ ""ОТРАДНЕНСКАЯ ЦРБ"" МЗ КК";врач-терапевт участковый;8;1120;1770;1593;177;1.42;779;0
"ГБУЗ ""ОТРАДНЕНСКАЯ ЦРБ"" МЗ КК";врач-хирург;1;85;122;110;12;1.29;107;0
ГБУЗ СПБ № 6;врач-психиатр детский;1;85;66;64;2;0.75;66;0
ГБУЗ СПБ № 7;врач-психиатр-нарколог;2;170;128;128;0;0.75;128;0
"ГБУЗ ""ПАВЛОВСКАЯ СП"" МЗ КК";врач-стоматолог;3;135;105;98;7;0.73;53;1
"ГБУЗ ""ПАВЛОВСКАЯ СП"" МЗ КК";врач-стоматолог детский;1;45;116;57;59;1.27;110;0
"ГБУЗ ""ПАВЛОВСКАЯ СП"" МЗ КК";врач-стоматолог-терапевт;1.75;78;73;63;10;0.81;28;1
ГБУЗ ПАВЛОВСКАЯ ЦРБ;врач - детский хирург;0.25;21;40;40;0;1.9;0;0
ГБУЗ ПАВЛОВСКАЯ ЦРБ;врач общей практики (семейный врач);2.25;292;267;267;0;0.91;146;0
ГБУЗ ПАВЛОВСКАЯ ЦРБ;врач-акушер-гинеколог;1;110;248;117;131;1.06;248;0
ГБУЗ ПАВЛОВСКАЯ ЦРБ;врач-оториноларинголог;1.5;224;175;92;83;0.41;175;0
ГБУЗ ПАВЛОВСКАЯ ЦРБ;врач-офтальмолог;1;170;155;52;103;0.31;155;0
ГБУЗ ПАВЛОВСКАЯ ЦРБ;врач-педиатр участковый;11.25;1575;1778;1639;139;1.04;1066;0
ГБУЗ ПАВЛОВСКАЯ ЦРБ;врач-психиатр-нарколог;2;170;153;152;1;0.89;4;0
ГБУЗ ПАВЛОВСКАЯ ЦРБ;врач-терапевт участковый;13.5;1890;1744;1664;80;0.88;1387;0
ГБУЗ ПАВЛОВСКАЯ ЦРБ;врач-фтизиатр участковый;2;110;120;120;0;1.09;0;0
ГБУЗ ПАВЛОВСКАЯ ЦРБ;врач-хирург;1;85;164;163;1;1.92;163;0
"ГБУЗ ""ПРИМОРСКО-АХТАРСКАЯ СТОМАТОЛОГИЧЕСКАЯ ПОЛИКЛИНИКА"" МЗ КК";врач-стоматолог;5.5;247;371;358;13;1.45;121;0
"ГБУЗ ""ПРИМОРСКО-АХТАРСКАЯ СТОМАТОЛОГИЧЕСКАЯ ПОЛИКЛИНИКА"" МЗ КК";врач-стоматолог детский;1;45;76;50;26;1.11;76;0
"ГБУЗ ""ПРИМОРСКО-АХТАРСКАЯ ЦРБ ИМ.КРАВЧЕНКО Н.Г."" МЗ КК";врач общей практики (семейный врач);3.25;422;495;495;0;1.17;301;0
"ГБУЗ ""ПРИМОРСКО-АХТАРСКАЯ ЦРБ ИМ.КРАВЧЕНКО Н.Г."" МЗ КК";врач-акушер-гинеколог;3.5;385;364;337;27;0.88;346;1
"ГБУЗ ""ПРИМОРСКО-АХТАРСКАЯ ЦРБ ИМ.КРАВЧЕНКО Н.Г."" МЗ КК";врач-оториноларинголог;2;300;284;211;73;0.7;284;0
"ГБУЗ ""ПРИМОРСКО-АХТАРСКАЯ ЦРБ ИМ.КРАВЧЕНКО Н.Г."" МЗ КК";врач-офтальмолог;1;170;120;119;1;0.7;120;0
"ГБУЗ ""ПРИМОРСКО-АХТАРСКАЯ ЦРБ ИМ.КРАВЧЕНКО Н.Г."" МЗ КК";врач-педиатр участковый;6.75;945;894;848;46;0.9;543;0
"ГБУЗ ""ПРИМОРСКО-АХТАРСКАЯ ЦРБ ИМ.КРАВЧЕНКО Н.Г."" МЗ КК";врач-психиатр детский;0;0;44;33;11;0;44;0
"ГБУЗ ""ПРИМОРСКО-АХТАРСКАЯ ЦРБ ИМ.КРАВЧЕНКО Н.Г."" МЗ КК";врач-психиатр-нарколог;1.25;106;126;125;1;1.18;58;0
"ГБУЗ ""ПРИМОРСКО-АХТАРСКАЯ ЦРБ ИМ.КРАВЧЕНКО Н.Г."" МЗ КК";врач-терапевт участковый;14.5;2030;1747;1581;166;0.78;1186;2
"ГБУЗ ""ПРИМОРСКО-АХТАРСКАЯ ЦРБ ИМ.КРАВЧЕНКО Н.Г."" МЗ КК";врач-хирург;2;170;206;136;70;0.8;156;0
"ГБУЗ ""СЕВЕРСКАЯ РСП"" МЗ КК";врач-стоматолог;8;360;212;194;18;0.54;202;2
"ГБУЗ ""СЕВЕРСКАЯ РСП"" МЗ КК";врач-стоматолог детский;2.5;112;104;96;8;0.86;81;0
"ГБУЗ ""СЕВЕРСКАЯ РСП"" МЗ КК";врач-стоматолог-терапевт;5.25;236;122;114;8;0.48;122;2
"ГБУЗ ""СЕВЕРСКАЯ ЦРБ"" МЗ КК";врач - детский хирург;0.5;42;120;117;3;2.79;120;0
"ГБУЗ ""СЕВЕРСКАЯ ЦРБ"" МЗ КК";врач общей практики (семейный врач);2;260;358;358;0;1.38;0;0
"ГБУЗ ""СЕВЕРСКАЯ ЦРБ"" МЗ КК";врач-акушер-гинеколог;13.25;1457;1390;1209;181;0.83;1226;2
"ГБУЗ ""СЕВЕРСКАЯ ЦРБ"" МЗ КК";врач-оториноларинголог;2.5;375;383;178;205;0.47;383;0
"ГБУЗ ""СЕВЕРСКАЯ ЦРБ"" МЗ КК";врач-офтальмолог;3;510;508;336;172;0.66;508;0
"ГБУЗ ""СЕВЕРСКАЯ ЦРБ"" МЗ КК";врач-педиатр участковый;25.25;3535;3736;3522;214;1;2377;1
"ГБУЗ ""СЕВЕРСКАЯ ЦРБ"" МЗ КК";врач-психиатр детский;1;85;110;109;1;1.28;110;0
"ГБУЗ ""СЕВЕРСКАЯ ЦРБ"" МЗ КК";врач-психиатр-нарколог;1.75;148;180;180;0;1.22;43;0
"ГБУЗ ""СЕВЕРСКАЯ ЦРБ"" МЗ КК";врач-терапевт участковый;24.5;3430;3513;3027;486;0.88;3062;2
"ГБУЗ ""СЕВЕРСКАЯ ЦРБ"" МЗ КК";врач-фтизиатр участковый;3.5;192;160;159;1;0.83;83;1
"ГБУЗ ""СЕВЕРСКАЯ ЦРБ"" МЗ КК";врач-хирург;1.5;127;148;61;87;0.48;148;0
"ГАУЗ ""СЛАВЯНСКАЯ СТОМАТОЛОГИЧЕСКАЯ ПОЛИКЛИНИКА"" МЗ КК";врач-стоматолог;11.5;514;657;556;101;1.08;361;1
"ГАУЗ ""СЛАВЯНСКАЯ СТОМАТОЛОГИЧЕСКАЯ ПОЛИКЛИНИКА"" МЗ КК";врач-стоматолог детский;1.75;78;104;68;36;0.87;104;0
"ГАУЗ ""СЛАВЯНСКАЯ СТОМАТОЛОГИЧЕСКАЯ ПОЛИКЛИНИКА"" МЗ КК";врач-стоматолог-терапевт;0.75;33;56;43;13;1.3;50;0
"ГБУЗ ""СЛАВЯНСКАЯ ЦРБ"" МЗ КК";врач - детский хирург;0.5;42;30;28;2;0.67;22;1
"ГБУЗ ""СЛАВЯНСКАЯ ЦРБ"" МЗ КК";врач общей практики (семейный врач);5.5;714;714;708;6;0.99;231;0
"ГБУЗ ""СЛАВЯНСКАЯ ЦРБ"" МЗ КК";врач-акушер-гинеколог;5.5;604;586;370;216;0.61;518;2
"ГБУЗ ""СЛАВЯНСКАЯ ЦРБ"" МЗ КК";врач-оториноларинголог;1;150;124;100;24;0.67;97;0
"ГБУЗ ""СЛАВЯНСКАЯ ЦРБ"" МЗ КК";врач-офтальмолог;3.25;552;218;141;77;0.26;218;2
"ГБУЗ ""СЛАВЯНСКАЯ ЦРБ"" МЗ КК";врач-педиатр участковый;18.25;2555;2723;2489;234;0.97;1554;0
"ГБУЗ ""СЛАВЯНСКАЯ ЦРБ"" МЗ КК";врач-психиатр детский;1;85;69;69;0;0.81;0;0
"ГБУЗ ""СЛАВЯНСКАЯ ЦРБ"" МЗ КК";врач-психиатр-нарколог;2;170;225;225;0;1.32;6;0
"ГБУЗ ""СЛАВЯНСКАЯ ЦРБ"" МЗ КК";врач-стоматолог;1;45;0;0;0;0;0;1
"ГБУЗ ""СЛАВЯНСКАЯ ЦРБ"" МЗ КК";врач-терапевт участковый;12.5;1750;2061;1731;330;0.99;1824;1
"ГБУЗ ""СЛАВЯНСКАЯ ЦРБ"" МЗ КК";врач-хирург;2;170;191;85;106;0.5;191;0
ГБУЗ ПТД № 12;врач-фтизиатр участковый;12.25;668;780;780;0;1.17;0;1
"ГБУЗ ""ГБ № 1 Г.СОЧИ"" МЗ КК";врач - детский хирург;1;85;86;68;18;0.8;83;0
"ГБУЗ ""ГБ № 1 Г.СОЧИ"" МЗ КК";врач общей практики (семейный врач);2.5;324;320;286;34;0.88;182;0
"ГБУЗ ""ГБ № 1 Г.СОЧИ"" МЗ КК";врач-акушер-гинеколог;4.25;467;438;314;124;0.67;427;0
"ГБУЗ ""ГБ № 1 Г.СОЧИ"" МЗ КК";врач-оториноларинголог;1.75;262;246;235;11;0.9;228;0
"ГБУЗ ""ГБ № 1 Г.СОЧИ"" МЗ КК";врач-офтальмолог;2.5;424;418;359;59;0.85;331;0
"ГБУЗ ""ГБ № 1 Г.СОЧИ"" МЗ КК";врач-педиатр участковый;9;1260;1225;1113;112;0.88;644;1
"ГБУЗ ""ГБ № 1 Г.СОЧИ"" МЗ КК";врач-терапевт участковый;9.75;1365;1465;1201;264;0.88;1132;0
"ГБУЗ ""ГБ № 1 Г.СОЧИ"" МЗ КК";врач-хирург;1.25;106;88;88;0;0.83;88;0
"ГБУЗ ""ГБ № 3 Г.СОЧИ"" МЗ КК";врач - детский хирург;0.25;21;53;17;36;0.81;53;0
"ГБУЗ ""ГБ № 3 Г.СОЧИ"" МЗ КК";врач-акушер-гинеколог;0.5;55;105;71;34;1.29;93;0
"ГБУЗ ""ГБ № 3 Г.СОЧИ"" МЗ КК";врач-офтальмолог;1.5;255;254;113;141;0.44;254;0
"ГБУЗ ""ГБ № 3 Г.СОЧИ"" МЗ КК";врач-педиатр участковый;6;840;870;635;235;0.76;798;1
"ГБУЗ ""ГБ № 3 Г.СОЧИ"" МЗ КК";врач-терапевт участковый;5.5;770;721;711;10;0.92;598;0
"ГБУЗ ""ГБ № 3 Г.СОЧИ"" МЗ КК";врач-хирург;0.75;63;72;72;0;1.14;72;0
"ГБУЗ ""ГБ № 4 Г.СОЧИ"" МЗ КК";врач-акушер-гинеколог;0.5;55;52;0;52;0;52;0
"ГБУЗ ""ГБ № 4 Г.СОЧИ"" МЗ КК";врач-оториноларинголог;0.5;75;75;62;13;0.83;75;0
"ГБУЗ ""ГБ № 4 Г.СОЧИ"" МЗ КК";врач-офтальмолог;0.25;42;52;0;52;0;52;0
"ГБУЗ ""ГБ № 4 Г.СОЧИ"" МЗ КК";врач-терапевт участковый;6.5;910;937;770;167;0.85;882;0
"ГБУЗ ""ГБ № 4 Г.СОЧИ"" МЗ КК";врач-хирург;0.5;42;45;0;45;0;45;0
"ГБУЗ ""ГБ № 8 Г. СОЧИ"" МЗ КК";врач-акушер-гинеколог;1;110;115;70;45;0.64;115;0
"ГБУЗ ""ГБ № 8 Г. СОЧИ"" МЗ КК";врач-оториноларинголог;1;150;120;72;48;0.48;120;0
"ГБУЗ ""ГБ № 8 Г. СОЧИ"" МЗ КК";врач-офтальмолог;1.25;212;92;92;0;0.43;65;0
"ГБУЗ ""ГБ № 8 Г. СОЧИ"" МЗ КК";врач-педиатр участковый;3;420;392;392;0;0.93;74;0
"ГБУЗ ""ГБ № 8 Г. СОЧИ"" МЗ КК";врач-стоматолог;1;44;49;22;27;0.5;49;0
"ГБУЗ ""ГБ № 8 Г. СОЧИ"" МЗ КК";врач-стоматолог-терапевт;0.5;22;22;14;8;0.64;22;0
"ГБУЗ ""ГБ № 8 Г. СОЧИ"" МЗ КК";врач-терапевт участковый;4;560;504;325;179;0.58;504;0
"ГБУЗ ""ГБ № 8 Г. СОЧИ"" МЗ КК";врач-хирург;0.5;42;40;33;7;0.79;40;0
"ГБУЗ ""ГП № 1 Г. СОЧИ"" МЗ КК";врач общей практики (семейный врач);1;130;130;130;0;1;43;0
"ГБУЗ ""ГП № 1 Г. СОЧИ"" МЗ КК";врач-акушер-гинеколог;2;220;260;258;2;1.17;91;0
"ГБУЗ ""ГП № 1 Г. СОЧИ"" МЗ КК";врач-оториноларинголог;1.5;225;325;246;79;1.09;321;0
"ГБУЗ ""ГП № 1 Г. СОЧИ"" МЗ КК";врач-офтальмолог;1.5;255;174;116;58;0.45;136;0
"ГБУЗ ""ГП № 1 Г. СОЧИ"" МЗ КК";врач-терапевт участковый;29.75;4165;4441;3877;564;0.93;3509;1
"ГБУЗ ""ГП № 1 Г. СОЧИ"" МЗ КК";врач-хирург;2.75;233;398;296;102;1.27;388;1
"ГБУЗ ""ГП № 2 Г.СОЧИ"" МЗ КК";врач-акушер-гинеколог;2.75;302;344;182;162;0.6;335;0
"ГБУЗ ""ГП № 2 Г.СОЧИ"" МЗ КК";врач-оториноларинголог;2;300;294;199;95;0.66;292;0
"ГБУЗ ""ГП № 2 Г.СОЧИ"" МЗ КК";врач-офтальмолог;3;510;494;284;210;0.56;493;0
"ГБУЗ ""ГП № 2 Г.СОЧИ"" МЗ КК";врач-терапевт участковый;21.5;3010;3450;2337;1113;0.78;3114;0
"ГБУЗ ""ГП № 2 Г.СОЧИ"" МЗ КК";врач-хирург;4.75;403;529;303;226;0.75;529;0
"ГБУЗ ""ГП № 3 Г. СОЧИ"" МЗ КК";врач общей практики (семейный врач);2.5;325;309;261;48;0.8;90;0
"ГБУЗ ""ГП № 3 Г. СОЧИ"" МЗ КК";врач-акушер-гинеколог;1;110;110;110;0;1;107;0
"ГБУЗ ""ГП № 3 Г. СОЧИ"" МЗ КК";врач-оториноларинголог;1.5;225;180;129;51;0.57;159;0
"ГБУЗ ""ГП № 3 Г. СОЧИ"" МЗ КК";врач-офтальмолог;1;170;175;81;94;0.48;175;0
"ГБУЗ ""ГП № 3 Г. СОЧИ"" МЗ КК";врач-терапевт участковый;9.5;1330;1330;890;440;0.67;1328;0
"ГБУЗ ""ГП № 3 Г. СОЧИ"" МЗ КК";врач-хирург;1.5;127;124;102;22;0.8;122;0
"ГБУЗ ""ГП № 4 Г. СОЧИ"" МЗ КК";врач - детский хирург;0.25;21;48;48;0;2.29;48;0
"ГБУЗ ""ГП № 4 Г. СОЧИ"" МЗ КК";врач общей практики (семейный врач);0.25;32;40;40;0;1.25;40;0
"ГБУЗ ""ГП № 4 Г. СОЧИ"" МЗ КК";врач-акушер-гинеколог;5;550;361;218;143;0.4;361;1
"ГБУЗ ""ГП № 4 Г. СОЧИ"" МЗ КК";врач-оториноларинголог;0.75;112;76;45;31;0.4;76;0
"ГБУЗ ""ГП № 4 Г. СОЧИ"" МЗ КК";врач-офтальмолог;2.25;382;327;270;57;0.71;295;0
"ГБУЗ ""ГП № 4 Г. СОЧИ"" МЗ КК";врач-педиатр участковый;6.25;875;1008;732;276;0.84;902;0
"ГБУЗ ""ГП № 4 Г. СОЧИ"" МЗ КК";врач-стоматолог;1.25;56;56;31;25;0.55;56;0
"ГБУЗ ""ГП № 4 Г. СОЧИ"" МЗ КК";врач-стоматолог детский;1.25;56;30;0;30;0;30;1
"ГБУЗ ""ГП № 4 Г. СОЧИ"" МЗ КК";врач-стоматолог-терапевт;2.75;123;122;55;67;0.45;121;0
"ГБУЗ ""ГП № 4 Г. СОЧИ"" МЗ КК";врач-терапевт участковый;5.75;805;630;535;95;0.66;630;2
"ГБУЗ ""ГП № 4 Г. СОЧИ"" МЗ КК";врач-хирург;2;170;102;77;25;0.45;99;1
"ГБУЗ ""КРАЕВАЯ БОЛЬНИЦА № 4""";врач-акушер-гинеколог;0.75;82;43;34;9;0.41;43;0
"ГБУЗ ""КРАЕВАЯ БОЛЬНИЦА № 4""";врач-оториноларинголог;0.5;75;44;0;44;0;44;0
"ГБУЗ ""КРАЕВАЯ БОЛЬНИЦА № 4""";врач-офтальмолог;1.25;212;130;33;97;0.16;130;0
"ГБУЗ ""КРАЕВАЯ БОЛЬНИЦА № 4""";врач-педиатр участковый;15.75;2205;2380;2037;343;0.92;2067;0
"ГБУЗ ""ПНД № 3""";врач-психиатр детский;2.25;191;199;119;80;0.62;199;0
"ГБУЗ ""СП № 1 Г. СОЧИ"" МЗ КК";врач-стоматолог;4.75;212;557;401;156;1.89;290;1
"ГБУЗ ""СП № 1 Г. СОЧИ"" МЗ КК";врач-стоматолог-терапевт;10.5;470;1078;733;345;1.56;692;3
"ГБУЗ ""СП № 2 Г. СОЧИ"" МЗ КК";врач-стоматолог;8.25;369;399;261;138;0.71;399;2
"ГБУЗ ""СП № 2 Г. СОЧИ"" МЗ КК";врач-стоматолог детский;5;225;365;186;179;0.83;360;0
"ГБУЗ ""СП № 2 Г. СОЧИ"" МЗ КК";врач-стоматолог-терапевт;8.75;392;403;283;120;0.72;350;1
"ГБУЗ ""СП № 3 Г.СОЧИ"" МЗ КК";врач-стоматолог;6;268;371;248;123;0.93;267;0
"ГБУЗ ""СП № 3 Г.СОЧИ"" МЗ КК";врач-стоматолог детский;1;45;42;42;0;0.93;2;0
"ГБУЗ ""СП № 3 Г.СОЧИ"" МЗ КК";врач-стоматолог-терапевт;1;45;42;42;0;0.93;37;0
"ГБУЗ ""СП № 4 Г. СОЧИ"" МЗ КК";врач-стоматолог;6.5;289;265;213;52;0.74;264;2
"ГБУЗ ""СП № 4 Г. СОЧИ"" МЗ КК";врач-стоматолог детский;1.75;77;78;65;13;0.84;78;1
"ГБУЗ ""СП № 4 Г. СОЧИ"" МЗ КК";врач-стоматолог-терапевт;1.5;67;78;58;20;0.87;78;0
"ГБУЗ ""УБ № 3 Г. СОЧИ"" МЗ КК";врач общей практики (семейный врач);1;130;140;140;0;1.08;130;0
"ГБУЗ ""УБ № 3 Г. СОЧИ"" МЗ КК";врач-стоматолог;1;45;0;0;0;0;0;1
"ГБУЗ ""ЦОМИД Г. СОЧИ"" МЗ КК";врач - детский хирург;2.25;191;265;174;91;0.91;265;0
"ГБУЗ ""ЦОМИД Г. СОЧИ"" МЗ КК";врач-акушер-гинеколог;34.5;3786;2920;2156;764;0.57;2867;11
"ГБУЗ ""ЦОМИД Г. СОЧИ"" МЗ КК";врач-оториноларинголог;2.75;412;408;312;96;0.76;350;0
"ГБУЗ ""ЦОМИД Г. СОЧИ"" МЗ КК";врач-офтальмолог;2;339;306;179;127;0.53;306;1
"ГБУЗ ""ЦОМИД Г. СОЧИ"" МЗ КК";врач-педиатр участковый;44.75;6265;5736;4545;1191;0.73;4810;4
"ГБУЗ ""ЦОМИД Г. СОЧИ"" МЗ КК";врач-стоматолог детский;11;494;501;249;252;0.5;501;2
ГБУЗ ПТД № 1;врач-фтизиатр участковый;20.5;1120;1038;985;53;0.88;534;0
"ГБУЗ ""СТАРОМИНСКАЯ ЦРБ"" МЗ КК";врач общей практики (семейный врач);2.5;325;423;385;38;1.18;155;0
"ГБУЗ ""СТАРОМИНСКАЯ ЦРБ"" МЗ КК";врач-акушер-гинеколог;3;330;313;189;124;0.57;284;0
"ГБУЗ ""СТАРОМИНСКАЯ ЦРБ"" МЗ КК";врач-оториноларинголог;2.5;375;190;155;35;0.41;100;0
"ГБУЗ ""СТАРОМИНСКАЯ ЦРБ"" МЗ КК";врач-офтальмолог;1.75;297;120;60;60;0.2;119;0
"ГБУЗ ""СТАРОМИНСКАЯ ЦРБ"" МЗ КК";врач-педиатр участковый;9;1260;918;863;55;0.68;533;0
"ГБУЗ ""СТАРОМИНСКАЯ ЦРБ"" МЗ КК";врач-психиатр детский;1;85;35;0;35;0;35;1
"ГБУЗ ""СТАРОМИНСКАЯ ЦРБ"" МЗ КК";врач-психиатр-нарколог;2;170;55;55;0;0.32;0;0
"ГБУЗ ""СТАРОМИНСКАЯ ЦРБ"" МЗ КК";врач-стоматолог;0;0;45;34;11;0;35;0
"ГБУЗ ""СТАРОМИНСКАЯ ЦРБ"" МЗ КК";врач-стоматолог-терапевт;0.75;33;0;0;0;0;0;2
"ГБУЗ ""СТАРОМИНСКАЯ ЦРБ"" МЗ КК";врач-терапевт участковый;10.5;1470;1383;1236;147;0.84;738;1
"ГБУЗ ""СТАРОМИНСКАЯ ЦРБ"" МЗ КК";врач-хирург;2;170;52;37;15;0.22;49;1
"ГБУЗ ""ТБИЛИССКАЯ ЦРБ"" МЗ КК";врач - детский хирург;0;0;12;0;12;0;12;0
"ГБУЗ ""ТБИЛИССКАЯ ЦРБ"" МЗ КК";врач общей практики (семейный врач);0.5;65;201;198;3;3.05;56;0
"ГБУЗ ""ТБИЛИССКАЯ ЦРБ"" МЗ КК";врач-акушер-гинеколог;1;110;193;26;167;0.24;193;1
"ГБУЗ ""ТБИЛИССКАЯ ЦРБ"" МЗ КК";врач-офтальмолог;3;510;480;468;12;0.92;306;0
"ГБУЗ ""ТБИЛИССКАЯ ЦРБ"" МЗ КК";врач-педиатр участковый;5.75;805;689;663;26;0.82;511;1
"ГБУЗ ""ТБИЛИССКАЯ ЦРБ"" МЗ КК";врач-психиатр-нарколог;1.75;148;140;140;0;0.95;74;1
"ГБУЗ ""ТБИЛИССКАЯ ЦРБ"" МЗ КК";врач-стоматолог;4;179;154;154;0;0.86;91;2
"ГБУЗ ""ТБИЛИССКАЯ ЦРБ"" МЗ КК";врач-стоматолог детский;1.25;56;80;80;0;1.43;75;0
"ГБУЗ ""ТБИЛИССКАЯ ЦРБ"" МЗ КК";врач-стоматолог-терапевт;1;45;86;86;0;1.91;23;0
"ГБУЗ ""ТБИЛИССКАЯ ЦРБ"" МЗ КК";врач-терапевт участковый;7.25;1015;1101;854;247;0.84;636;0
"ГБУЗ ""ТБИЛИССКАЯ ЦРБ"" МЗ КК";врач-фтизиатр;0;0;120;120;0;0;1;0
"ГБУЗ ""ТБИЛИССКАЯ ЦРБ"" МЗ КК";врач-фтизиатр участковый;2;109;0;0;0;0;0;2
"ГБУЗ ""ТБИЛИССКАЯ ЦРБ"" МЗ КК";врач-хирург;2;170;220;197;23;1.16;214;0
"ГБУЗ ""ТЕМРЮКСКАЯ ЦРБ"" МЗ КК";врач - детский хирург;1.5;127;120;106;14;0.83;107;0
"ГБУЗ ""ТЕМРЮКСКАЯ ЦРБ"" МЗ КК";врач общей практики (семейный врач);14;1819;1681;1594;87;0.88;971;0
"ГБУЗ ""ТЕМРЮКСКАЯ ЦРБ"" МЗ КК";врач-акушер-гинеколог;8.75;962;773;595;178;0.62;618;0
"ГБУЗ ""ТЕМРЮКСКАЯ ЦРБ"" МЗ КК";врач-оториноларинголог;3.25;487;200;151;49;0.31;200;1
"ГБУЗ ""ТЕМРЮКСКАЯ ЦРБ"" МЗ КК";врач-офтальмолог;3.5;595;492;400;92;0.67;469;0
"ГБУЗ ""ТЕМРЮКСКАЯ ЦРБ"" МЗ КК";врач-педиатр участковый;18.5;2590;2537;2273;264;0.88;1532;0
"ГБУЗ ""ТЕМРЮКСКАЯ ЦРБ"" МЗ КК";врач-психиатр детский;1;85;85;81;4;0.95;81;0
"ГБУЗ ""ТЕМРЮКСКАЯ ЦРБ"" МЗ КК";врач-психиатр-нарколог;0.5;42;92;92;0;2.19;82;0
"ГБУЗ ""ТЕМРЮКСКАЯ ЦРБ"" МЗ КК";врач-психиатр-нарколог участковый;1;85;0;0;0;0;0;1
"ГБУЗ ""ТЕМРЮКСКАЯ ЦРБ"" МЗ КК";врач-стоматолог;7.75;347;317;279;38;0.8;228;2
"ГБУЗ ""ТЕМРЮКСКАЯ ЦРБ"" МЗ КК";врач-стоматолог детский;1;45;93;77;16;1.71;66;0
"ГБУЗ ""ТЕМРЮКСКАЯ ЦРБ"" МЗ КК";врач-стоматолог-терапевт;2.5;112;134;99;35;0.88;120;0
"ГБУЗ ""ТЕМРЮКСКАЯ ЦРБ"" МЗ КК";врач-терапевт участковый;18.5;2590;2017;1677;340;0.65;1664;3
"ГБУЗ ""ТЕМРЮКСКАЯ ЦРБ"" МЗ КК";врач-хирург;3.5;297;215;168;47;0.57;215;1
"ГБУЗ ""ТИМАШЕВСКАЯ ЦРБ"" МЗ КК";врач - детский хирург;1;85;230;230;0;2.71;157;0
"ГБУЗ ""ТИМАШЕВСКАЯ ЦРБ"" МЗ КК";врач общей практики (семейный врач);3.25;422;817;799;18;1.89;360;0
"ГБУЗ ""ТИМАШЕВСКАЯ ЦРБ"" МЗ КК";врач-акушер-гинеколог;5.75;631;578;400;178;0.63;428;2
"ГБУЗ ""ТИМАШЕВСКАЯ ЦРБ"" МЗ КК";врач-оториноларинголог;3.25;487;444;444;0;0.91;185;0
"ГБУЗ ""ТИМАШЕВСКАЯ ЦРБ"" МЗ КК";врач-офтальмолог;1.5;254;74;68;6;0.27;72;2
"ГБУЗ ""ТИМАШЕВСКАЯ ЦРБ"" МЗ КК";врач-педиатр участковый;18;2520;3966;3833;133;1.52;1576;0
"ГБУЗ ""ТИМАШЕВСКАЯ ЦРБ"" МЗ КК";врач-психиатр детский;0.5;42;79;79;0;1.88;77;0
"ГБУЗ ""ТИМАШЕВСКАЯ ЦРБ"" МЗ КК";врач-психиатр-нарколог;1.75;148;102;102;0;0.69;0;1
"ГБУЗ ""ТИМАШЕВСКАЯ ЦРБ"" МЗ КК";врач-стоматолог;12.75;571;2023;2021;2;3.54;311;1
"ГБУЗ ""ТИМАШЕВСКАЯ ЦРБ"" МЗ КК";врач-стоматолог-терапевт;4;179;239;239;0;1.34;75;1
"ГБУЗ ""ТИМАШЕВСКАЯ ЦРБ"" МЗ КК";врач-терапевт участковый;16.5;2310;3602;3200;402;1.39;1530;1
"ГБУЗ ""ТИМАШЕВСКАЯ ЦРБ"" МЗ КК";врач-фтизиатр участковый;3.25;178;253;252;1;1.42;101;0
"ГБУЗ ""ТИМАШЕВСКАЯ ЦРБ"" МЗ КК";врач-хирург;2.75;233;311;311;0;1.33;177;1
"ГБУЗ ""ТИХОРЕЦКАЯ ЦРБ"" МЗ КК";врач - детский хирург;1;85;176;70;106;0.82;171;0
"ГБУЗ ""ТИХОРЕЦКАЯ ЦРБ"" МЗ КК";врач общей практики (семейный врач);1;130;102;100;2;0.77;54;0
"ГБУЗ ""ТИХОРЕЦКАЯ ЦРБ"" МЗ КК";врач-акушер-гинеколог;4.5;494;602;433;169;0.88;512;0
"ГБУЗ ""ТИХОРЕЦКАЯ ЦРБ"" МЗ КК";врач-оториноларинголог;1.25;187;171;0;171;0;171;0
"ГБУЗ ""ТИХОРЕЦКАЯ ЦРБ"" МЗ КК";врач-офтальмолог;2.5;424;299;222;77;0.52;282;0
"ГБУЗ ""ТИХОРЕЦКАЯ ЦРБ"" МЗ КК";врач-педиатр участковый;16.75;2345;1745;1611;134;0.69;1295;3
"ГБУЗ ""ТИХОРЕЦКАЯ ЦРБ"" МЗ КК";врач-психиатр детский участковый;0.25;21;0;0;0;0;0;1
"ГБУЗ ""ТИХОРЕЦКАЯ ЦРБ"" МЗ КК";врач-психиатр-нарколог;3;254;300;300;0;1.18;0;1
"ГБУЗ ""ТИХОРЕЦКАЯ ЦРБ"" МЗ КК";врач-стоматолог;13.25;594;1189;1029;160;1.73;512;2
"ГБУЗ ""ТИХОРЕЦКАЯ ЦРБ"" МЗ КК";врач-терапевт участковый;17.25;2415;1989;1652;337;0.68;1374;4
"ГБУЗ ""ТИХОРЕЦКАЯ ЦРБ"" МЗ КК";врач-фтизиатр;0;0;85;85;0;0;67;0
"ГБУЗ ""ТИХОРЕЦКАЯ ЦРБ"" МЗ КК";врач-фтизиатр участковый;1.75;95;50;50;0;0.53;0;2
"ГБУЗ ""ТИХОРЕЦКАЯ ЦРБ"" МЗ КК";врач-хирург;1.25;106;130;35;95;0.33;130;1
"ГБУЗ ""ТСП"" МЗ КК";врач-стоматолог;8.5;381;242;209;33;0.55;153;3
"ГБУЗ ""ТСП"" МЗ КК";врач-стоматолог-терапевт;6;270;395;330;65;1.22;324;0
"ГБУЗ ""ТУАПСИНСКАЯ РАЙОННАЯ БОЛЬНИЦА № 3""";врач-акушер-гинеколог;1.5;164;103;74;29;0.45;97;0
"ГБУЗ ""ТУАПСИНСКАЯ РАЙОННАЯ БОЛЬНИЦА № 3""";врач-оториноларинголог;0.5;75;12;12;0;0.16;12;0
"ГБУЗ ""ТУАПСИНСКАЯ РАЙОННАЯ БОЛЬНИЦА № 3""";врач-офтальмолог;1;170;100;93;7;0.55;94;0
"ГБУЗ ""ТУАПСИНСКАЯ РАЙОННАЯ БОЛЬНИЦА № 3""";врач-психиатр-нарколог;0.25;21;0;0;0;0;0;1
"ГБУЗ ""ТУАПСИНСКАЯ РАЙОННАЯ БОЛЬНИЦА № 3""";врач-стоматолог-терапевт;2;89;67;52;15;0.58;62;0
"ГБУЗ ""ТУАПСИНСКАЯ РАЙОННАЯ БОЛЬНИЦА № 3""";врач-терапевт участковый;4;560;328;229;99;0.41;325;1
"ГБУЗ ""ТУАПСИНСКАЯ РАЙОННАЯ БОЛЬНИЦА № 3""";врач-хирург;1;84;85;73;12;0.87;84;0
"ГБУЗ ""ТУАПСИНСКАЯ ЦРБ № 2"" МЗ КК";врач - детский хирург;0.25;21;200;200;0;9.52;105;1
"ГБУЗ ""ТУАПСИНСКАЯ ЦРБ № 2"" МЗ КК";врач общей практики (семейный врач);1.25;162;146;132;14;0.81;72;0
"ГБУЗ ""ТУАПСИНСКАЯ ЦРБ № 2"" МЗ КК";врач-акушер-гинеколог;3.75;412;405;389;16;0.94;261;0
"ГБУЗ ""ТУАПСИНСКАЯ ЦРБ № 2"" МЗ КК";врач-оториноларинголог;1.5;225;60;46;14;0.2;60;1
"ГБУЗ ""ТУАПСИНСКАЯ ЦРБ № 2"" МЗ КК";врач-офтальмолог;2.25;382;382;312;70;0.82;262;0
"ГБУЗ ""ТУАПСИНСКАЯ ЦРБ № 2"" МЗ КК";врач-педиатр участковый;6.75;945;673;673;0;0.71;235;1
"ГБУЗ ""ТУАПСИНСКАЯ ЦРБ № 2"" МЗ КК";врач-терапевт участковый;7.25;1015;915;833;82;0.82;482;3
"ГБУЗ ""ТУАПСИНСКАЯ ЦРБ № 2"" МЗ КК";врач-хирург;1;85;100;100;0;1.18;100;0
"ГБУЗ ""ТУАПСИНСКАЯ ЦРБ № 4"" МЗ КК";врач-акушер-гинеколог;0.5;55;20;10;10;0.18;20;0
"ГБУЗ ""ТУАПСИНСКАЯ ЦРБ № 4"" МЗ КК";врач-оториноларинголог;0.25;37;1;0;1;0;1;0
"ГБУЗ ""ТУАПСИНСКАЯ ЦРБ № 4"" МЗ КК";врач-офтальмолог;0.25;42;50;50;0;1.19;4;0
"ГБУЗ ""ТУАПСИНСКАЯ ЦРБ № 4"" МЗ КК";врач-педиатр участковый;2;280;520;520;0;1.86;113;0
"ГБУЗ ""ТУАПСИНСКАЯ ЦРБ № 4"" МЗ КК";врач-терапевт участковый;4.5;630;570;570;0;0.9;178;0
"ГБУЗ ""ТУАПСИНСКАЯ ЦРБ № 4"" МЗ КК";врач-хирург;1;85;79;0;79;0;79;0
"ГБУЗ ""ТЦРБ № 1"" МЗ КК";врач - детский хирург;0;0;10;0;10;0;10;0
"ГБУЗ ""ТЦРБ № 1"" МЗ КК";врач общей практики (семейный врач);0.5;64;0;0;0;0;0;2
"ГБУЗ ""ТЦРБ № 1"" МЗ КК";врач-акушер-гинеколог;6.5;714;792;551;241;0.77;715;0
"ГБУЗ ""ТЦРБ № 1"" МЗ КК";врач-оториноларинголог;3;450;413;282;131;0.63;316;0
"ГБУЗ ""ТЦРБ № 1"" МЗ КК";врач-офтальмолог;0.75;127;95;81;14;0.64;95;1
"ГБУЗ ""ТЦРБ № 1"" МЗ КК";врач-педиатр участковый;11.5;1610;1554;1274;280;0.79;1078;1
"ГБУЗ ""ТЦРБ № 1"" МЗ КК";врач-терапевт участковый;20.5;2870;2612;1976;636;0.69;2320;1
"ГБУЗ ""ТЦРБ № 1"" МЗ КК";врач-хирург;3.25;275;279;197;82;0.72;269;0
ГБУЗ ПНД № 4;врач-психиатр детский;1.5;127;164;79;85;0.62;85;0
"ГБУЗ ""УСПЕНСКАЯ ЦРБ"" МЗ КК";врач - детский хирург;0.5;42;39;23;16;0.55;39;0
"ГБУЗ ""УСПЕНСКАЯ ЦРБ"" МЗ КК";врач общей практики (семейный врач);2;260;120;120;0;0.46;0;1
"ГБУЗ ""УСПЕНСКАЯ ЦРБ"" МЗ КК";врач-акушер-гинеколог;3;330;138;105;33;0.32;138;1
"ГБУЗ ""УСПЕНСКАЯ ЦРБ"" МЗ КК";врач-оториноларинголог;0.25;37;38;0;38;0;38;0
"ГБУЗ ""УСПЕНСКАЯ ЦРБ"" МЗ КК";врач-офтальмолог;1.5;255;148;78;70;0.31;148;1
"ГБУЗ ""УСПЕНСКАЯ ЦРБ"" МЗ КК";врач-педиатр участковый;8;1120;608;549;59;0.49;379;4
"ГБУЗ ""УСПЕНСКАЯ ЦРБ"" МЗ КК";врач-психиатр детский;0.25;21;25;25;0;1.19;3;0
"ГБУЗ ""УСПЕНСКАЯ ЦРБ"" МЗ КК";врач-психиатр-нарколог;1.25;106;90;90;0;0.85;0;1
"ГБУЗ ""УСПЕНСКАЯ ЦРБ"" МЗ КК";врач-стоматолог;3;135;196;147;49;1.09;175;0
"ГБУЗ ""УСПЕНСКАЯ ЦРБ"" МЗ КК";врач-терапевт участковый;8.5;1190;989;708;281;0.59;721;3
"ГБУЗ ""УСПЕНСКАЯ ЦРБ"" МЗ КК";врач-фтизиатр участковый;1;55;88;0;88;0;88;0
"ГБУЗ ""УСПЕНСКАЯ ЦРБ"" МЗ КК";врач-хирург;1;85;140;100;40;1.18;140;0
"ГБУЗ ""УСТЬ-ЛАБИНСКАЯ СП"" МЗ КК";врач-стоматолог;8.25;369;315;315;0;0.85;6;2
"ГБУЗ ""УСТЬ-ЛАБИНСКАЯ СП"" МЗ КК";врач-стоматолог детский;4;179;91;91;0;0.51;0;2
"ГБУЗ ""УСТЬ-ЛАБИНСКАЯ СП"" МЗ КК";врач-стоматолог-терапевт;3.25;146;79;79;0;0.54;0;2
"ГБУЗ ""УСТЬ-ЛАБИНСКАЯ ЦРБ"" МЗ КК";врач - детский хирург;1;85;166;137;29;1.61;165;0
"ГБУЗ ""УСТЬ-ЛАБИНСКАЯ ЦРБ"" МЗ КК";врач общей практики (семейный врач);2.25;292;280;261;19;0.89;136;0
"ГБУЗ ""УСТЬ-ЛАБИНСКАЯ ЦРБ"" МЗ КК";врач-акушер-гинеколог;5.75;631;577;504;73;0.8;450;2
"ГБУЗ ""УСТЬ-ЛАБИНСКАЯ ЦРБ"" МЗ КК";врач-оториноларинголог;4;600;522;475;47;0.79;435;0
"ГБУЗ ""УСТЬ-ЛАБИНСКАЯ ЦРБ"" МЗ КК";врач-офтальмолог;3;510;488;411;77;0.81;429;0
"ГБУЗ ""УСТЬ-ЛАБИНСКАЯ ЦРБ"" МЗ КК";врач-педиатр участковый;15.25;2135;1985;1892;93;0.89;982;1
"ГБУЗ ""УСТЬ-ЛАБИНСКАЯ ЦРБ"" МЗ КК";врач-психиатр детский;0.5;42;35;14;21;0.33;35;0
"ГБУЗ ""УСТЬ-ЛАБИНСКАЯ ЦРБ"" МЗ КК";врач-психиатр-нарколог;0.5;42;108;97;11;2.31;26;0
"ГБУЗ ""УСТЬ-ЛАБИНСКАЯ ЦРБ"" МЗ КК";врач-терапевт участковый;16.75;2345;2017;1652;365;0.7;1589;1
"ГБУЗ ""УСТЬ-ЛАБИНСКАЯ ЦРБ"" МЗ КК";врач-хирург;3;255;242;171;71;0.67;239;0
"ГБУЗ ""ЩЕРБИНОВСКАЯ ЦРБ"" МЗ КК";врач - детский хирург;0.25;21;49;0;49;0;49;0
"ГБУЗ ""ЩЕРБИНОВСКАЯ ЦРБ"" МЗ КК";врач общей практики (семейный врач);2.25;292;379;379;0;1.3;181;0
"ГБУЗ ""ЩЕРБИНОВСКАЯ ЦРБ"" МЗ КК";врач-акушер-гинеколог;0.25;27;103;4;99;0.15;103;0
"ГБУЗ ""ЩЕРБИНОВСКАЯ ЦРБ"" МЗ КК";врач-оториноларинголог;2;300;200;186;14;0.62;200;0
"ГБУЗ ""ЩЕРБИНОВСКАЯ ЦРБ"" МЗ КК";врач-офтальмолог;1;170;86;75;11;0.44;86;0
"ГБУЗ ""ЩЕРБИНОВСКАЯ ЦРБ"" МЗ КК";врач-педиатр участковый;4.75;665;448;334;114;0.5;443;0
"ГБУЗ ""ЩЕРБИНОВСКАЯ ЦРБ"" МЗ КК";врач-психиатр детский;1;85;51;0;51;0;51;0
"ГБУЗ ""ЩЕРБИНОВСКАЯ ЦРБ"" МЗ КК";врач-психиатр-нарколог;0;0;64;64;0;0;1;0
"ГБУЗ ""ЩЕРБИНОВСКАЯ ЦРБ"" МЗ КК";врач-психиатр-нарколог участковый;1.25;106;0;0;0;0;0;1
"ГБУЗ ""ЩЕРБИНОВСКАЯ ЦРБ"" МЗ КК";врач-стоматолог;3.75;168;76;35;41;0.21;76;2
"ГБУЗ ""ЩЕРБИНОВСКАЯ ЦРБ"" МЗ КК";врач-стоматолог детский;0.5;22;10;0;10;0;10;0
"ГБУЗ ""ЩЕРБИНОВСКАЯ ЦРБ"" МЗ КК";врач-терапевт участковый;5;700;598;584;14;0.83;285;0
"ГБУЗ ""ЩЕРБИНОВСКАЯ ЦРБ"" МЗ КК";врач-фтизиатр участковый;2;110;46;40;6;0.36;9;0
"ГБУЗ ""ЩЕРБИНОВСКАЯ ЦРБ"" МЗ КК";врач-хирург;0;0;60;0;60;0;60;0
